"af" = (/obj/machinery/mineral/equipment_vendor/casino_chip_vendor,/turf/open/floor/wood,/area/awaymission/casino/lounge)
"ak" = (/obj/machinery/door/airlock/centcom,/turf/open/floor/wood,/area/awaymission/casino/maintenance)
"am" = (/turf/open/floor/plasteel/dark/corner{dir = 4},/area/awaymission/casino/lounge)
"aO" = (/obj/structure/sign/poster/official/walk,/turf/closed/indestructible/riveted,/area/awaymission/casino/security)
"aQ" = (/turf/open/floor/plasteel/stairs/right,/area/awaymission/casino/lounge)
"cw" = (/obj/machinery/gateway/away{calibrated = 0},/turf/open/floor/plasteel/dark,/area/awaymission/casino/security)
"cA" = (/obj/structure/table/reinforced,/obj/item/lighter/clockwork,/turf/open/floor/plasteel/dark/side,/area/awaymission/casino/lounge)
"cC" = (/obj/structure/sign/poster/official/safety_report,/turf/closed/indestructible/riveted,/area/awaymission/casino/security)
"du" = (/obj/structure/chair/office{dir = 8},/turf/open/floor/plasteel/dark,/area/awaymission/casino/security)
"dL" = (/turf/closed/indestructible/riveted,/area/awaymission/casino/pit)
"dN" = (/obj/machinery/vending/cola/random,/turf/open/floor/wood,/area/awaymission/casino/lounge)
"dP" = (/turf/open/floor/plasteel/stairs/left,/area/awaymission/casino/lounge)
"dU" = (/obj/structure/chair/comfy/black{dir = 4},/turf/open/floor/carpet/royalblack,/area/awaymission/casino/pit)
"eu" = (/obj/effect/spawner/structure/window/reinforced,/turf/open/floor/plating,/area/awaymission/casino/pit)
"fs" = (/turf/open/floor/wood,/area/awaymission/casino/lounge)
"gs" = (/turf/open/floor/carpet/green,/area/awaymission/casino/pit)
"gu" = (/obj/effect/turf_decal/bot_white/left,/obj/effect/turf_decal/tile/neutral{dir = 1},/obj/effect/turf_decal/tile/neutral,/obj/effect/turf_decal/tile/neutral{dir = 4},/obj/effect/turf_decal/tile/neutral{dir = 8},/turf/open/floor/plasteel/dark,/area/awaymission/casino/security)
"gx" = (/obj/structure/table,/obj/item/toy/cards/deck/tournament,/obj/item/toy/cards/deck/tournament,/obj/item/toy/cards/deck/tournament,/turf/open/floor/plasteel/showroomfloor,/area/awaymission/casino/maintenance)
"gI" = (/obj/machinery/door/airlock/glass_large{name = "Casino Pits Entry"},/turf/open/floor/wood,/area/awaymission/casino/pit)
"hQ" = (/turf/open/floor/plasteel/dark,/area/awaymission/casino/security)
"ih" = (/obj/effect/spawner/structure/window/reinforced/indestructable,/turf/open/floor/plating,/area/awaymission/casino/lounge)
"iu" = (/obj/structure/table/reinforced,/turf/open/floor/plasteel/dark/side,/area/awaymission/casino/lounge)
"iO" = (/obj/machinery/computer/camera_advanced/syndie{dir = 1; name = "speedway camera console"; networks = list("speedway")},/turf/open/floor/wood,/area/awaymission/casino/lounge)
"iZ" = (/obj/structure/sign/poster/official/report_crimes,/turf/closed/indestructible/riveted,/area/awaymission/casino/security)
"jE" = (/obj/structure/railing{dir = 8},/turf/open/floor/plasteel/showroomfloor,/area/awaymission/casino/security)
"jF" = (/obj/structure/table,/obj/item/storage/box/poker_chips/five_thousand,/turf/open/floor/plasteel/showroomfloor,/area/awaymission/casino/maintenance)
"km" = (/obj/machinery/door/airlock/centcom{name = "Casino Brig"},/turf/open/floor/plasteel/dark,/area/awaymission/casino/security)
"kn" = (/obj/effect/turf_decal/tile/blue,/obj/effect/turf_decal/tile/blue{dir = 8},/obj/effect/turf_decal/tile/blue{dir = 1},/turf/open/floor/plasteel/white,/area/awaymission/casino/lounge)
"kx" = (/obj/structure/table,/obj/machinery/chem_dispenser/drinks,/turf/open/floor/plasteel/checker,/area/awaymission/casino/lounge)
"kA" = (/obj/structure/table/reinforced,/turf/open/floor/plasteel/dark/side{dir = 4},/area/awaymission/casino/lounge)
"kK" = (/turf/open/floor/plasteel/dark/corner{dir = 1},/area/awaymission/casino/lounge)
"kQ" = (/obj/machinery/door/window/westleft,/turf/open/floor/plasteel/showroomfloor,/area/awaymission/casino/security)
"mq" = (/obj/structure/sign/poster/official/help_others,/turf/closed/indestructible/riveted,/area/awaymission/casino/security)
"ni" = (/obj/machinery/button/door{id = "casino_entryway_shutters"; name = "Entryway Lockdown"; pixel_x = -24},/obj/structure/table/reinforced,/obj/machinery/recharger,/turf/open/floor/plasteel/dark,/area/awaymission/casino/security)
"nu" = (/obj/structure/table/reinforced,/obj/machinery/door/window/brigdoor/security{dir = 4},/obj/machinery/door/window{dir = 8},/turf/open/floor/plating,/area/awaymission/casino/security)
"nN" = (/turf/closed/indestructible/riveted,/area/awaymission/casino/lounge)
"nX" = (/turf/open/floor/carpet/royalblack,/area/awaymission/casino/pit)
"nY" = (/obj/structure/railing{dir = 1},/turf/open/floor/plasteel/showroomfloor,/area/awaymission/casino/security)
"ot" = (/obj/structure/chair/stool/bar,/turf/open/floor/plasteel/dark/side{dir = 1},/area/awaymission/casino/lounge)
"oz" = (/obj/structure/table/wood/bar,/obj/item/reagent_containers/food/snacks/burger/cheese,/turf/open/floor/carpet/royalblack,/area/awaymission/casino/lounge)
"oD" = (/obj/structure/chair/comfy/black,/turf/open/floor/carpet/royalblack,/area/awaymission/casino/pit)
"oM" = (/obj/structure/chair/comfy/black{dir = 1},/turf/open/floor/carpet/royalblack,/area/awaymission/casino/pit)
"oP" = (/turf/closed/indestructible/riveted,/area/awaymission/casino/maintenance)
"pi" = (/obj/structure/table/wood/poker,/obj/item/toy/cards/deck,/turf/open/floor/wood,/area/awaymission/casino/lounge)
"py" = (/obj/effect/turf_decal/bot_white,/obj/effect/turf_decal/tile/neutral{dir = 1},/obj/effect/turf_decal/tile/neutral,/obj/effect/turf_decal/tile/neutral{dir = 4},/obj/effect/turf_decal/tile/neutral{dir = 8},/turf/open/floor/plasteel/dark,/area/awaymission/casino/security)
"pD" = (/obj/structure/chair/stool,/turf/open/floor/wood,/area/awaymission/casino/lounge)
"qg" = (/turf/closed/indestructible/riveted,/area/space)
"qk" = (/obj/structure/table,/obj/machinery/reagentgrinder,/obj/item/reagent_containers/food/drinks/shaker,/turf/open/floor/plasteel/checker,/area/awaymission/casino/lounge)
"qL" = (/obj/structure/sign/poster/official/no_erp,/turf/closed/indestructible/riveted,/area/awaymission/casino/security)
"rH" = (/obj/structure/table/wood/poker,/turf/open/floor/carpet/green,/area/awaymission/casino/pit)
"sA" = (/obj/machinery/door/window/northright,/turf/open/floor/plasteel/showroomfloor,/area/awaymission/casino/security)
"tk" = (/obj/machinery/door/poddoor/shutters/preopen{id = "casino_entryway_shutters"},/turf/open/floor/plasteel/showroomfloor,/area/awaymission/casino/security)
"tC" = (/obj/structure/railing{dir = 4},/turf/open/floor/wood,/area/awaymission/casino/lounge)
"tT" = (/obj/machinery/vending/cola/random,/turf/open/floor/plasteel/showroomfloor,/area/awaymission/casino/maintenance)
"ue" = (/obj/structure/reagent_dispensers/beerkeg,/turf/open/floor/plasteel/checker,/area/awaymission/casino/lounge)
"uU" = (/turf/open/floor/plasteel/dark/side{dir = 4},/area/awaymission/casino/lounge)
"vd" = (/obj/machinery/sleeper{dir = 8},/obj/effect/turf_decal/tile/blue{dir = 1},/obj/effect/turf_decal/tile/blue{dir = 4},/turf/open/floor/plasteel/white,/area/awaymission/casino/lounge)
"vr" = (/obj/structure/closet/secure_closet/personal,/turf/open/floor/plasteel/showroomfloor,/area/awaymission/casino/security)
"vw" = (/obj/machinery/light,/turf/closed/indestructible/riveted,/area/awaymission/casino/maintenance)
"zD" = (/obj/structure/curtain/cloth/fancy,/turf/open/floor/wood,/area/awaymission/casino/pit)
"Br" = (/obj/structure/table/wood/poker,/turf/open/floor/wood,/area/awaymission/casino/lounge)
"BG" = (/obj/structure/table/wood/bar,/obj/item/reagent_containers/food/snacks/burger/baseball,/turf/open/floor/carpet/royalblack,/area/awaymission/casino/lounge)
"BZ" = (/turf/open/floor/plasteel/stairs/medium,/area/awaymission/casino/lounge)
"Cq" = (/obj/structure/closet/secure_closet/bar,/turf/open/floor/plasteel/showroomfloor,/area/awaymission/casino/maintenance)
"CO" = (/turf/open/floor/wood,/area/awaymission/casino/pit)
"DO" = (/obj/structure/chair/stool/bar,/turf/open/floor/plasteel/dark/side{dir = 8},/area/awaymission/casino/lounge)
"Gg" = (/obj/structure/table/wood/poker,/obj/item/flashlight/lamp/green,/turf/open/floor/wood,/area/awaymission/casino/pit)
"He" = (/obj/machinery/vending/snack/random,/turf/open/floor/wood,/area/awaymission/casino/lounge)
"Hu" = (/obj/structure/chair/wood{dir = 4},/turf/open/floor/carpet/royalblack,/area/awaymission/casino/lounge)
"HZ" = (/obj/machinery/vending/boozeomat,/turf/open/floor/plasteel/checker,/area/awaymission/casino/lounge)
"Ic" = (/obj/machinery/computer/security,/turf/open/floor/plasteel/dark,/area/awaymission/casino/security)
"IV" = (/obj/structure/sign/poster/official/obey,/turf/closed/indestructible/riveted,/area/awaymission/casino/security)
"Jk" = (/obj/structure/closet/secure_closet/security,/turf/open/floor/plasteel/dark,/area/awaymission/casino/security)
"Jn" = (/obj/structure/table/wood/poker,/turf/open/floor/wood,/area/awaymission/casino/pit)
"Js" = (/obj/structure/table/reinforced,/obj/item/gun/energy/e_gun/advtaser,/turf/open/floor/plasteel/dark,/area/awaymission/casino/security)
"JX" = (/obj/effect/landmark/awaystart,/turf/open/floor/plasteel/dark,/area/awaymission/casino/security)
"KU" = (/obj/effect/spawner/structure/window/reinforced,/turf/open/floor/plating,/area/awaymission/casino/security)
"LE" = (/obj/structure/railing{dir = 8},/turf/open/floor/wood,/area/awaymission/casino/lounge)
"Mx" = (/obj/structure/closet/secure_closet/brig,/turf/open/floor/plasteel/dark,/area/awaymission/casino/security)
"Nf" = (/obj/structure/chair/comfy/black{dir = 8},/turf/open/floor/carpet/royalblack,/area/awaymission/casino/pit)
"Nn" = (/obj/effect/spawner/structure/window/reinforced,/turf/open/floor/wood,/area/awaymission/casino/pit)
"Oe" = (/obj/machinery/door/window/westright,/turf/open/floor/plasteel/showroomfloor,/area/awaymission/casino/security)
"Of" = (/turf/open/floor/plasteel/showroomfloor,/area/awaymission/casino/security)
"Oj" = (/obj/machinery/door/window/northleft,/turf/open/floor/plasteel/showroomfloor,/area/awaymission/casino/security)
"Pa" = (/obj/machinery/vending/cigarette,/turf/open/floor/wood,/area/awaymission/casino/lounge)
"Pi" = (/obj/structure/table/reinforced,/obj/item/reagent_containers/glass/rag,/turf/open/floor/plasteel/dark/side,/area/awaymission/casino/lounge)
"Pn" = (/turf/open/floor/carpet/royalblack,/area/awaymission/casino/lounge)
"Pw" = (/obj/structure/railing/corner{dir = 1},/turf/open/floor/plasteel/showroomfloor,/area/awaymission/casino/security)
"PL" = (/obj/structure/sink/kitchen{pixel_y = 28},/turf/open/floor/plasteel/checker,/area/awaymission/casino/lounge)
"PO" = (/obj/machinery/door/window/southright{dir = 8; name = "Bar Door"; req_one_access_txt = "0"},/turf/open/floor/plasteel/dark/side{dir = 8},/area/awaymission/casino/lounge)
"PU" = (/obj/machinery/modular_computer/console/preset/command{dir = 1},/turf/open/floor/plating,/area/awaymission/casino/security)
"PV" = (/obj/machinery/vending/snack/random,/turf/open/floor/plasteel/showroomfloor,/area/awaymission/casino/maintenance)
"Qa" = (/obj/structure/chair/wood{dir = 8},/turf/open/floor/carpet/royalblack,/area/awaymission/casino/lounge)
"QB" = (/obj/effect/turf_decal/bot_white/right,/obj/effect/turf_decal/tile/neutral{dir = 1},/obj/effect/turf_decal/tile/neutral,/obj/effect/turf_decal/tile/neutral{dir = 4},/obj/effect/turf_decal/tile/neutral{dir = 8},/turf/open/floor/plasteel/dark,/area/awaymission/casino/security)
"QM" = (/obj/effect/turf_decal/tile/blue,/obj/effect/turf_decal/tile/blue{dir = 4},/obj/effect/turf_decal/tile/blue{dir = 8},/obj/structure/table,/obj/item/storage/firstaid/brute{pixel_x = 3; pixel_y = 3},/obj/item/storage/firstaid/o2,/obj/item/storage/firstaid/regular{pixel_x = -3; pixel_y = -3},/turf/open/floor/plasteel/white,/area/awaymission/casino/lounge)
"Rl" = (/turf/open/space/basic,/area/space)
"Ru" = (/obj/structure/table/reinforced,/turf/open/floor/plasteel/dark/side{dir = 8},/area/awaymission/casino/lounge)
"Rz" = (/obj/structure/table/reinforced,/obj/item/book/manual/wiki/barman_recipes,/turf/open/floor/plasteel/dark/side{dir = 4},/area/awaymission/casino/lounge)
"RY" = (/obj/structure/chair/stool/bar,/turf/open/floor/plasteel/dark/side{dir = 4},/area/awaymission/casino/lounge)
"Sb" = (/obj/effect/turf_decal/tile/blue{dir = 1},/obj/effect/turf_decal/tile/blue{dir = 4},/obj/effect/turf_decal/tile/blue{dir = 8},/obj/machinery/vending/wallmed{pixel_y = 31},/turf/open/floor/plasteel/white,/area/awaymission/casino/lounge)
"SO" = (/obj/structure/bed,/turf/open/floor/plasteel/dark,/area/awaymission/casino/security)
"SS" = (/turf/open/floor/plasteel/showroomfloor,/area/awaymission/casino/maintenance)
"SV" = (/obj/structure/table/wood/poker,/obj/item/clothing/mask/cigarette/cigar,/turf/open/floor/wood,/area/awaymission/casino/lounge)
"Tg" = (/obj/structure/closet/secure_closet/personal,/obj/structure/closet/secure_closet/personal,/turf/open/floor/plasteel/showroomfloor,/area/awaymission/casino/security)
"Uc" = (/obj/machinery/door/airlock/centcom{name = "Casino Security"},/turf/open/floor/plating,/area/awaymission/casino/security)
"Ug" = (/obj/structure/table,/obj/machinery/chem_dispenser/drinks/beer,/turf/open/floor/plasteel/checker,/area/awaymission/casino/lounge)
"Wo" = (/turf/closed/indestructible/riveted,/area/awaymission/casino/security)
"WQ" = (/obj/structure/chair/stool/bar,/turf/open/floor/wood,/area/awaymission/casino/lounge)
"Xi" = (/obj/machinery/door/airlock/centcom{name = "Casino Security"},/turf/open/floor/plasteel/dark,/area/awaymission/casino/security)
"Yd" = (/obj/item/kirbyplants/random,/turf/open/floor/plasteel/showroomfloor,/area/awaymission/casino/security)
"YD" = (/obj/machinery/light,/turf/closed/indestructible/riveted,/area/awaymission/casino/pit)
"Zp" = (/obj/machinery/door/airlock/centcom,/turf/open/floor/plasteel/dark,/area/awaymission/casino/security)
"ZQ" = (/turf/open/floor/plasteel/checker,/area/awaymission/casino/lounge)

(1,1,1) = {"
RlRlRlRlRlRlRlRlRlRlRlRlRlRlRlRlRlRlRlRlRlRlRlRlRlRlRlRlRlRlRlRlRlRlRlRlRlRlRlRlRlRlRlRlRlRlRlRlRlRl
RlRlRlRlRlRlRlRlRlRlRlRlRlRlRlRlRlRlRlRlRlRlRlRlRlRlRlRlRlRlRlRlRlRlRlRlRlRlRlRlRlRlRlRlRlRlRlRlRlRl
RlRlRlRlRlRlRlRlRlRlRlRlRlRlRlRlRlRlRlRlRlRlRlRlRlRlRlRlRlRlRlRlRlRlRlRlRlRlRlRlRlRlRlRlRlRlRlRlRlRl
RlRlRlRlRlRlRlRlRlRlRlRlRlRlRlRlRlRlRlRlRlRlRlRlRlRlRlRlRlRlRlRlRlRlRlRlRlRlRlRlRlRlRlRlRlRlRlRlRlRl
RlRlRlRlRlRlRlRlRlRlRlRlRlRlRlRlRlRlRlRlRlRlRlRlRlRlRlRlRlRlRlRlRlRlRlRlRlRlRlRlRlRlRlRlRlRlRlRlRlRl
RlRlRlRlRlRlRlRlRlRlRlRlRlRlRlRlRlRlRlRlRlRlRlRlRlRlRlRlRlRlRlRlRlRlRlRlRlRlRlRlRlRlRlRlRlRlRlRlRlRl
RlRlRlRlRlRlRlRlRlRlRlRlRlRlRlRlRlRlRlRlRlRlRlRlRlRlRlRlRlRlRlRlRlRlRlRlRlRlRlRlRlRlRlRlRlRlRlRlRlRl
RlRlRlRlRlRlRlRlRlRlRlRlRlRlRlRlRlRlRlRlRlRlRlRlRlRlRlRlRlRlRlRlRlRlRlRlRlRlRlRlRlRlRlRlRlRlRlRlRlRl
RlRlRlRlRlRlRlRlRlRlRlRlRlRlRlRlRlRlRlRlRlRlRlRlRlRlRlRlRlRlRlRlRlRlRlRlRlRlRlRlRlRlRlRlRlRlRlRlRlRl
RlRlRlRlRlRlRlRlRlRlRlRlRlRlRlRlRlRlRlRlRlRlRlRlRlRlRlRlRlRlRlRlRlRlRlRlRlRlRlRlRlRlRlRlRlRlRlRlRlRl
RlRlRlRlRlRlRlRlRlRlRlRlRlRlRlRlRlRlRlRlRlRlRlRlRlRlRlRlRlRlRlRlRlRlRlRlRlRlRlRlRlRlRlRlRlRlRlRlRlRl
RlRlRlRlRlRlRlRlRlRlRlRlRlRlRlRlRlRlRlRlRlRlRlRlRlRlRlRlRlRlRlRlRlRlRlRlRlRlRlRlRlRlRlRlRlRlRlRlRlRl
RlRlRlRlRlRlRlRlRlRlRlRlRlRlRlRlRlRlRlRlRlRlRlRlRlRlRlRlRlRlRlRlRlRlRlRlRlRlRlRlRlRlRlRlRlRlRlRlRlRl
RlRlRlRlRlRlRlRlRlRlRlRlRlRlRlRlRlRlRlRlRlRlRlRlRlRlRlRlRlRlRlRlRlRlRlRlRlRlRlRlRlRlRlRlRlRlRlRlRlRl
RlRlRlRlRlRlRlRlRlRlRlRlRlRlRlRlRlRlRlRlRlRlRlRlRlRlRlRlRlRlRlRlRlRlRlRlRlRlRlRlRlRlRlRlRlRlRlRlRlRl
RlRlRlRlRlRlRlRlRlRlRlRlRlRlRlRlRlRlRlRlRlRlRlRlRlRlRlRlRlRlRlRlRlRlRlRlRlRlRlRlRlRlRlRlRlRlRlRlRlRl
RlRlRlRlRlRlRlRlRlRlRlRlRlRlRlRlRlRloPoPoPoPoPoPoPoPoPoPoPoPoPRlRlRlRlRlRlRlRlRlRlRlRlRlRlRlRlRlRlRl
RlRlRlRlRlRlRlRlRlRlRlRlRlRlRlRlRloPoPCqCqgxgxgxgxgxgxjFjFjFoPoPRlRlRlRlRlRlRlRlRlRlRlRlRlRlRlRlRlRl
RlRlRlRlRlRlRlRlRlRlRlRlRlRlRlRloPoPSSSSSSSSSSSSSSSSSSSSSSSSSSoPoPRlRlRlRlRlRlRlRlRlRlRlRlRlRlRlRlRl
RlRlRlRlRlRlRlRlRlRlRlRlRlRlRlRloPSSSSSSSSSStTtTPVPVtTtTSSSSSSSSoPRlRlRlRlRlRlRlRlRlRlRlRlRlRlRlRlRl
RlRlRlRlRlRlRlRlRlRlRldLdLdLYDdLvwoPoPoPakoPoPvwoPvwoPoPakoPoPoPvwdLYDdLdLdLdLRlRlRlRlRlRlRlRlRlRlRl
RlRlRlRlRlRlRlRlRlRlRldLnXnXnXnXnXnXnXCOCOnXnXnXnXnXnXnXCOCOnXnXnXnXnXnXnXCOdLRlRlRlRlRlRlRlRlRlRlRl
RlRlRlRlRlRlRlRlRlRlRldLdUJnGggsGgJnNfCOzDoDJnGggsGgJnoDzDCOdUJnGggsGgJnNfCOdLRlRlRlRlRlRlRlRlRlRlRl
RlRlRlRlRlRlRlRlRlRlRldLnXJngsgsgsJnnXCOzDnXJngsgsgsJnnXzDCOnXJngsgsgsJnnXCOdLRlRlRlRlRlRlRlRlRlRlRl
RlRlRlRlRlRlRlRlRlRlRldLdUJngsrHgsJnNfCOzDoDJngsrHgsJnoDzDCOdUJngsrHgsJnNfCOdLRlRlRlRlRlRlRlRlRlRlRl
RlRlRlRlRlRlRlRlRlRlRlYDnXGgJnJnJnGgnXCOzDnXGgJnJnJnGgnXzDCOnXGgJnJnJnGgnXCOdLRlRlRlRlRlRlRlRlRlRlRl
RlRlRlRlRlRlRlRlRlRlqgdLnXnXoMnXoMnXnXCOCOnXnXoMnXoMnXnXCOCOnXnXoMnXoMnXnXCOdLRlRlRlRlRlRlRlRlRlRlRl
RlRlRlRlnNnNnNnNnNnNnNdLeueueueueueugICOeueudLeueueueueueueueuNnNnNneueudLeudLRlRlRlRlRlRlRlRlRlRlRl
RlRlRlRlnNfsfsfsfsfsfsfsfsfsfsfsfsfsfsfsuUPOPLHZUgkxqkueRzDOfsfsfsfsfsfsSbvdnNRlRlRlRlRlRlRlRlRlRlRl
RlRlRlRlWotktkWoWoWoWoWoWoWofsfspDpDfsfsRYRuZQZQZQZQZQZQkADOfsfspDpDfsfsknQMnNRlRlRlRlRlRlRlRlRlRlRl
RlRlRlRlWoOfOfWoniJsJsJkJkWofspDBrSVpDfsRYRuZQZQZQZQZQZQkADOfspDBrSVpDfsPanNnNRlRlRlRlRlRlRlRlRlRlRl
RlRlRlRlWoOfOfKUIchQhQhQhQWofspDpiBrpDfsRYRuiuiucAPiiuiukADOfspDpiBrpDHenNnNRlRlRlRlRlRlRlRlRlRlRlRl
RlRlRlRlWoOfOfnuduhQhQhQhQUcfsfspDpDfsfsamototototototototkKfsfspDpDfsdNnNRlRlRlRlRlRlRlRlRlRlRlRlRl
RlRlRlRlWoOfOfKUPUhQWoWoWoWoWoafWQWQfsfsPnPnPnPnPnPnPnPnPnPnfsfsWQWQafnNnNRlRlRlRlRlRlRlRlRlRlRlRlRl
RlRlRlRlWoOfOfWoWoZpWohQhQSOWoWoiOiOfsfsPnPnPnPnPnPnPnPnPnPnfsfsiOiOihihRlRlRlRlRlRlRlRlRlRlRlRlRlRl
RlRlRlRlWoOfOfXihQhQkmhQhQhQMxWonNnNafWQWQtCdPBZBZBZBZaQLEWQWQafihihihRlRlRlRlRlRlRlRlRlRlRlRlRlRlRl
RlRlRlRlWotktkIVqLaOWoWoWoWoWoWoRlnNnNiOiOtCPnPnPnPnPnPnLEiOiOihihRlRlRlRlRlRlRlRlRlRlRlRlRlRlRlRlRl
RlRlRlRlWoOfOfOfOfOfWovrvrvrYdWoRlRlnNnNihihHuBGQaHuozQaihihihihRlRlRlRlRlRlRlRlRlRlRlRlRlRlRlRlRlRl
RlRlRlRlWoOfOfOfOfOfOfOfOfOfvrWoRlRlRlRlRlihihihihihihihihRlRlRlRlRlRlRlRlRlRlRlRlRlRlRlRlRlRlRlRlRl
RlRlRlRlWoWoWoWoWoOfWoOfOfOfvrWoRlRlRlRlRlRlRlRlRlRlRlRlRlRlRlRlRlRlRlRlRlRlRlRlRlRlRlRlRlRlRlRlRlRl
RlRlRlRlWoQBpyguJXjEcCOfOfOfTgWoRlRlRlRlRlRlRlRlRlRlRlRlRlRlRlRlRlRlRlRlRlRlRlRlRlRlRlRlRlRlRlRlRlRl
RlRlRlRlWopycwpyJXOeWovrvrvrYdWoRlRlRlRlRlRlRlRlRlRlRlRlRlRlRlRlRlRlRlRlRlRlRlRlRlRlRlRlRlRlRlRlRlRl
RlRlRlRlWogupyQBJXkQiZWoWoWoWoWoRlRlRlRlRlRlRlRlRlRlRlRlRlRlRlRlRlRlRlRlRlRlRlRlRlRlRlRlRlRlRlRlRlRl
RlRlRlRlWoJXJXJXJXjEWoRlRlRlRlRlRlRlRlRlRlRlRlRlRlRlRlRlRlRlRlRlRlRlRlRlRlRlRlRlRlRlRlRlRlRlRlRlRlRl
RlRlRlRlWonYOjsAnYPwmqRlRlRlRlRlRlRlRlRlRlRlRlRlRlRlRlRlRlRlRlRlRlRlRlRlRlRlRlRlRlRlRlRlRlRlRlRlRlRl
RlRlRlRlWoWoWoWoWoWoWoRlRlRlRlRlRlRlRlRlRlRlRlRlRlRlRlRlRlRlRlRlRlRlRlRlRlRlRlRlRlRlRlRlRlRlRlRlRlRl
RlRlRlRlRlRlRlRlRlRlRlRlRlRlRlRlRlRlRlRlRlRlRlRlRlRlRlRlRlRlRlRlRlRlRlRlRlRlRlRlRlRlRlRlRlRlRlRlRlRl
RlRlRlRlRlRlRlRlRlRlRlRlRlRlRlRlRlRlRlRlRlRlRlRlRlRlRlRlRlRlRlRlRlRlRlRlRlRlRlRlRlRlRlRlRlRlRlRlRlRl
RlRlRlRlRlRlRlRlRlRlRlRlRlRlRlRlRlRlRlRlRlRlRlRlRlRlRlRlRlRlRlRlRlRlRlRlRlRlRlRlRlRlRlRlRlRlRlRlRlRl
RlRlRlRlRlRlRlRlRlRlRlRlRlRlRlRlRlRlRlRlRlRlRlRlRlRlRlRlRlRlRlRlRlRlRlRlRlRlRlRlRlRlRlRlRlRlRlRlRlRl
"}
