"ab" = (/obj/machinery/mineral/equipment_vendor/casino_chip_vendor,/turf/open/floor/wood,/area/awaymission/casino/lounge)
"as" = (/obj/structure/table/reinforced,/obj/item/gun/energy/e_gun/advtaser,/turf/open/floor/plasteel/dark,/area/awaymission/casino/security)
"az" = (/obj/machinery/camera/emp_proof{dir = 10; name = "Casino Pit Camera"; network = list("casino")},/turf/open/floor/carpet/royalblack,/area/awaymission/casino/pit)
"aI" = (/obj/structure/table/wood/poker,/turf/open/floor/wood,/area/awaymission/casino/lounge)
"cN" = (/obj/structure/railing/corner{dir = 1},/turf/open/floor/plasteel/showroomfloor,/area/awaymission/casino/security)
"cU" = (/obj/machinery/computer/camera_advanced/syndie{dir = 1; name = "Casino Camera Console"; networks = list("casino")},/turf/open/floor/wood,/area/awaymission/casino/lounge)
"da" = (/obj/structure/table/reinforced,/obj/machinery/door/window/brigdoor/security{dir = 4},/obj/machinery/door/window{dir = 8},/turf/open/floor/plating,/area/awaymission/casino/security)
"dr" = (/obj/machinery/sleeper{dir = 8},/obj/effect/turf_decal/tile/blue{dir = 1},/obj/effect/turf_decal/tile/blue{dir = 4},/turf/open/floor/plasteel/white,/area/awaymission/casino/lounge)
"dU" = (/obj/structure/table/wood/poker,/obj/item/flashlight/lamp/green,/turf/open/floor/wood,/area/awaymission/casino/pit)
"ed" = (/obj/structure/reagent_dispensers/beerkeg,/turf/open/floor/plasteel/checker,/area/awaymission/casino/lounge)
"ev" = (/obj/structure/closet/secure_closet/brig,/turf/open/floor/plasteel/dark,/area/awaymission/casino/security)
"ey" = (/obj/effect/turf_decal/tile/blue{dir = 1},/obj/effect/turf_decal/tile/blue{dir = 4},/obj/effect/turf_decal/tile/blue{dir = 8},/obj/machinery/vending/wallmed{pixel_y = 31},/turf/open/floor/plasteel/white,/area/awaymission/casino/lounge)
"eI" = (/obj/structure/chair/stool/bar,/turf/open/floor/plasteel/dark/side{dir = 8},/area/awaymission/casino/lounge)
"fo" = (/obj/effect/turf_decal/bot_white/right,/obj/effect/turf_decal/tile/neutral{dir = 1},/obj/effect/turf_decal/tile/neutral,/obj/effect/turf_decal/tile/neutral{dir = 4},/obj/effect/turf_decal/tile/neutral{dir = 8},/turf/open/floor/plasteel/dark,/area/awaymission/casino/security)
"fu" = (/obj/machinery/door/airlock/glass_large{name = "Casino Pits Entry"},/turf/open/floor/wood,/area/awaymission/casino/pit)
"fL" = (/obj/structure/table/reinforced,/obj/item/lighter/clockwork,/turf/open/floor/plasteel/dark/side,/area/awaymission/casino/lounge)
"gB" = (/obj/machinery/vending/cola/random,/turf/open/floor/wood,/area/awaymission/casino/lounge)
"gJ" = (/obj/machinery/camera/emp_proof{dir = 5; name = "Casino Pit Camera"; network = list("casino")},/turf/open/floor/carpet/royalblack,/area/awaymission/casino/pit)
"hT" = (/obj/machinery/button/door{id = "casino_entryway_shutters"; name = "Entryway Lockdown"; pixel_x = -24},/obj/structure/table/reinforced,/obj/machinery/recharger,/turf/open/floor/plasteel/dark,/area/awaymission/casino/security)
"iX" = (/obj/machinery/vending/snack/random,/turf/open/floor/plasteel/showroomfloor,/area/awaymission/casino/maintenance)
"jD" = (/obj/effect/spawner/structure/window/reinforced,/turf/open/floor/plating,/area/awaymission/casino/security)
"jK" = (/turf/closed/indestructible/riveted,/area/awaymission/casino/pit)
"jQ" = (/obj/machinery/camera/emp_proof{name = "Casino Pit Camera"; network = list("casino")},/turf/open/floor/carpet/royalblack,/area/awaymission/casino/pit)
"ky" = (/obj/structure/closet/secure_closet/bar,/turf/open/floor/plasteel/showroomfloor,/area/awaymission/casino/maintenance)
"kV" = (/obj/structure/table/wood/bar,/obj/item/reagent_containers/food/snacks/burger/cheese,/turf/open/floor/carpet/royalblack,/area/awaymission/casino/lounge)
"lJ" = (/turf/open/space/basic,/area/space)
"mr" = (/obj/structure/table/wood/poker,/obj/item/clothing/mask/cigarette/cigar,/turf/open/floor/wood,/area/awaymission/casino/lounge)
"my" = (/obj/structure/chair/stool/bar,/turf/open/floor/wood,/area/awaymission/casino/lounge)
"ne" = (/turf/open/floor/carpet/green,/area/awaymission/casino/pit)
"ni" = (/obj/machinery/computer/security,/turf/open/floor/plasteel/dark,/area/awaymission/casino/security)
"nB" = (/obj/machinery/door/poddoor/shutters/preopen{id = "casino_entryway_shutters"},/turf/open/floor/plasteel/showroomfloor,/area/awaymission/casino/security)
"nC" = (/turf/closed/indestructible/riveted,/area/awaymission/casino/maintenance)
"oM" = (/turf/open/floor/plasteel/dark/corner{dir = 4},/area/awaymission/casino/lounge)
"oQ" = (/obj/structure/railing{dir = 4},/turf/open/floor/wood,/area/awaymission/casino/lounge)
"oR" = (/obj/machinery/door/airlock/centcom,/turf/open/floor/wood,/area/awaymission/casino/maintenance)
"oZ" = (/turf/open/floor/plasteel/showroomfloor,/area/awaymission/casino/maintenance)
"qm" = (/obj/structure/chair/comfy/black{dir = 8},/turf/open/floor/carpet/royalblack,/area/awaymission/casino/pit)
"qx" = (/obj/effect/spawner/structure/window/reinforced,/turf/open/floor/plating,/area/awaymission/casino/pit)
"qK" = (/obj/structure/chair/stool/bar,/turf/open/floor/plasteel/dark/side{dir = 4},/area/awaymission/casino/lounge)
"qQ" = (/obj/structure/sign/poster/official/help_others,/turf/closed/indestructible/riveted,/area/awaymission/casino/security)
"rX" = (/turf/open/floor/wood,/area/awaymission/casino/pit)
"sa" = (/obj/structure/table/wood/poker,/obj/item/toy/cards/deck,/turf/open/floor/wood,/area/awaymission/casino/lounge)
"sn" = (/obj/machinery/modular_computer/console/preset/command{dir = 1},/turf/open/floor/plating,/area/awaymission/casino/security)
"sH" = (/obj/structure/table/reinforced,/obj/item/reagent_containers/glass/rag,/turf/open/floor/plasteel/dark/side,/area/awaymission/casino/lounge)
"sL" = (/obj/machinery/door/airlock/centcom{name = "Casino Security"},/turf/open/floor/plating,/area/awaymission/casino/security)
"sY" = (/turf/open/floor/plasteel/stairs/medium,/area/awaymission/casino/lounge)
"ta" = (/obj/structure/closet/secure_closet/security,/turf/open/floor/plasteel/dark,/area/awaymission/casino/security)
"tU" = (/obj/structure/bed,/turf/open/floor/plasteel/dark,/area/awaymission/casino/security)
"uc" = (/obj/effect/spawner/structure/window/reinforced/indestructable,/turf/open/floor/plating,/area/awaymission/casino/lounge)
"up" = (/turf/open/floor/plasteel/showroomfloor,/area/awaymission/casino/security)
"uJ" = (/obj/structure/chair/office{dir = 8},/turf/open/floor/plasteel/dark,/area/awaymission/casino/security)
"uS" = (/obj/effect/landmark/awaystart,/turf/open/floor/plasteel/dark,/area/awaymission/casino/security)
"vU" = (/turf/closed/indestructible/riveted,/area/space)
"wX" = (/obj/machinery/vending/cigarette,/turf/open/floor/wood,/area/awaymission/casino/lounge)
"yC" = (/obj/structure/table,/obj/machinery/chem_dispenser/drinks,/turf/open/floor/plasteel/checker,/area/awaymission/casino/lounge)
"zc" = (/obj/structure/sign/poster/official/report_crimes,/turf/closed/indestructible/riveted,/area/awaymission/casino/security)
"zr" = (/obj/structure/curtain/cloth/fancy,/turf/open/floor/wood,/area/awaymission/casino/pit)
"Bz" = (/obj/structure/table,/obj/item/toy/cards/deck/tournament,/obj/item/toy/cards/deck/tournament,/obj/item/toy/cards/deck/tournament,/turf/open/floor/plasteel/showroomfloor,/area/awaymission/casino/maintenance)
"BW" = (/obj/item/kirbyplants/random,/turf/open/floor/plasteel/showroomfloor,/area/awaymission/casino/security)
"Ca" = (/obj/structure/table/reinforced,/turf/open/floor/plasteel/dark/side{dir = 4},/area/awaymission/casino/lounge)
"Ce" = (/obj/machinery/door/airlock/centcom{name = "Casino Security"},/turf/open/floor/plasteel/dark,/area/awaymission/casino/security)
"Eo" = (/obj/structure/table/reinforced,/turf/open/floor/plasteel/dark/side,/area/awaymission/casino/lounge)
"FU" = (/obj/structure/table,/obj/item/storage/box/poker_chips/five_thousand,/turf/open/floor/plasteel/showroomfloor,/area/awaymission/casino/maintenance)
"GE" = (/obj/structure/railing{dir = 1},/turf/open/floor/plasteel/showroomfloor,/area/awaymission/casino/security)
"GG" = (/obj/machinery/light,/turf/closed/indestructible/riveted,/area/awaymission/casino/pit)
"GH" = (/turf/closed/indestructible/riveted,/area/awaymission/casino/lounge)
"Ho" = (/obj/machinery/vending/snack/random,/turf/open/floor/wood,/area/awaymission/casino/lounge)
"Hp" = (/obj/structure/table,/obj/machinery/chem_dispenser/drinks/beer,/turf/open/floor/plasteel/checker,/area/awaymission/casino/lounge)
"HC" = (/obj/machinery/camera/emp_proof{dir = 9; name = "Casino Pit Camera"; network = list("casino")},/turf/open/floor/wood,/area/awaymission/casino/pit)
"Ic" = (/turf/open/floor/wood,/area/awaymission/casino/lounge)
"Ie" = (/obj/machinery/vending/boozeomat,/turf/open/floor/plasteel/checker,/area/awaymission/casino/lounge)
"Iy" = (/obj/structure/chair/stool,/turf/open/floor/wood,/area/awaymission/casino/lounge)
"IK" = (/turf/open/floor/plasteel/dark/corner{dir = 1},/area/awaymission/casino/lounge)
"IL" = (/turf/open/floor/plasteel/stairs/right,/area/awaymission/casino/lounge)
"Km" = (/obj/machinery/gateway/away{calibrated = 0},/turf/open/floor/plasteel/dark,/area/awaymission/casino/security)
"KH" = (/obj/machinery/door/airlock/centcom{name = "Casino Brig"},/turf/open/floor/plasteel/dark,/area/awaymission/casino/security)
"KX" = (/obj/structure/sink/kitchen{pixel_y = 28},/turf/open/floor/plasteel/checker,/area/awaymission/casino/lounge)
"LI" = (/turf/closed/indestructible/riveted,/area/awaymission/casino/security)
"Mo" = (/obj/structure/chair/stool/bar,/turf/open/floor/plasteel/dark/side{dir = 1},/area/awaymission/casino/lounge)
"Ne" = (/obj/effect/spawner/structure/window/reinforced,/turf/open/floor/wood,/area/awaymission/casino/pit)
"NX" = (/obj/structure/table/wood/bar,/obj/item/reagent_containers/food/snacks/burger/baseball,/turf/open/floor/carpet/royalblack,/area/awaymission/casino/lounge)
"OJ" = (/obj/structure/chair/comfy/black,/turf/open/floor/carpet/royalblack,/area/awaymission/casino/pit)
"OM" = (/obj/structure/closet/secure_closet/personal,/turf/open/floor/plasteel/showroomfloor,/area/awaymission/casino/security)
"ON" = (/turf/open/floor/plasteel/dark,/area/awaymission/casino/security)
"OO" = (/obj/structure/chair/comfy/black{dir = 1},/turf/open/floor/carpet/royalblack,/area/awaymission/casino/pit)
"OU" = (/obj/structure/chair/wood{dir = 8},/turf/open/floor/carpet/royalblack,/area/awaymission/casino/lounge)
"Pn" = (/obj/structure/chair/wood{dir = 4},/turf/open/floor/carpet/royalblack,/area/awaymission/casino/lounge)
"Qe" = (/turf/open/floor/plasteel/checker,/area/awaymission/casino/lounge)
"Qn" = (/obj/structure/table/wood/poker,/turf/open/floor/carpet/green,/area/awaymission/casino/pit)
"Qs" = (/obj/structure/table,/obj/machinery/reagentgrinder,/obj/item/reagent_containers/food/drinks/shaker,/turf/open/floor/plasteel/checker,/area/awaymission/casino/lounge)
"Qt" = (/obj/structure/sign/poster/official/walk,/turf/closed/indestructible/riveted,/area/awaymission/casino/security)
"QN" = (/obj/machinery/vending/cola/random,/turf/open/floor/plasteel/showroomfloor,/area/awaymission/casino/maintenance)
"Rh" = (/obj/effect/turf_decal/tile/blue,/obj/effect/turf_decal/tile/blue{dir = 4},/obj/effect/turf_decal/tile/blue{dir = 8},/obj/structure/table,/obj/item/storage/firstaid/brute{pixel_x = 3; pixel_y = 3},/obj/item/storage/firstaid/o2,/obj/item/storage/firstaid/regular{pixel_x = -3; pixel_y = -3},/turf/open/floor/plasteel/white,/area/awaymission/casino/lounge)
"Rr" = (/obj/machinery/light,/turf/closed/indestructible/riveted,/area/awaymission/casino/maintenance)
"Rs" = (/obj/structure/table/reinforced,/obj/item/book/manual/wiki/barman_recipes,/turf/open/floor/plasteel/dark/side{dir = 4},/area/awaymission/casino/lounge)
"RH" = (/obj/structure/closet/secure_closet/personal,/obj/structure/closet/secure_closet/personal,/turf/open/floor/plasteel/showroomfloor,/area/awaymission/casino/security)
"SL" = (/turf/open/floor/carpet/royalblack,/area/awaymission/casino/pit)
"SV" = (/obj/machinery/door/window/northleft,/turf/open/floor/plasteel/showroomfloor,/area/awaymission/casino/security)
"Tp" = (/obj/structure/sign/poster/official/no_erp,/turf/closed/indestructible/riveted,/area/awaymission/casino/security)
"TF" = (/obj/structure/chair/comfy/black{dir = 4},/turf/open/floor/carpet/royalblack,/area/awaymission/casino/pit)
"Ua" = (/obj/machinery/door/window/southright{dir = 8; name = "Bar Door"; req_one_access_txt = "0"},/turf/open/floor/plasteel/dark/side{dir = 8},/area/awaymission/casino/lounge)
"UK" = (/obj/structure/table/reinforced,/turf/open/floor/plasteel/dark/side{dir = 8},/area/awaymission/casino/lounge)
"UO" = (/obj/machinery/door/airlock/centcom,/turf/open/floor/plasteel/dark,/area/awaymission/casino/security)
"Vd" = (/obj/machinery/door/window/westleft,/turf/open/floor/plasteel/showroomfloor,/area/awaymission/casino/security)
"Vh" = (/turf/open/floor/carpet/royalblack,/area/awaymission/casino/lounge)
"Vr" = (/obj/effect/turf_decal/tile/blue,/obj/effect/turf_decal/tile/blue{dir = 8},/obj/effect/turf_decal/tile/blue{dir = 1},/turf/open/floor/plasteel/white,/area/awaymission/casino/lounge)
"Vy" = (/obj/effect/turf_decal/bot_white,/obj/effect/turf_decal/tile/neutral{dir = 1},/obj/effect/turf_decal/tile/neutral,/obj/effect/turf_decal/tile/neutral{dir = 4},/obj/effect/turf_decal/tile/neutral{dir = 8},/turf/open/floor/plasteel/dark,/area/awaymission/casino/security)
"WD" = (/obj/machinery/door/window/westright,/turf/open/floor/plasteel/showroomfloor,/area/awaymission/casino/security)
"WP" = (/turf/open/floor/plasteel/dark/side{dir = 4},/area/awaymission/casino/lounge)
"WT" = (/obj/structure/sign/poster/official/safety_report,/turf/closed/indestructible/riveted,/area/awaymission/casino/security)
"WU" = (/turf/open/floor/plasteel/stairs/left,/area/awaymission/casino/lounge)
"Xh" = (/obj/effect/turf_decal/bot_white/left,/obj/effect/turf_decal/tile/neutral{dir = 1},/obj/effect/turf_decal/tile/neutral,/obj/effect/turf_decal/tile/neutral{dir = 4},/obj/effect/turf_decal/tile/neutral{dir = 8},/turf/open/floor/plasteel/dark,/area/awaymission/casino/security)
"Xi" = (/obj/structure/sign/poster/official/obey,/turf/closed/indestructible/riveted,/area/awaymission/casino/security)
"Xl" = (/obj/structure/railing{dir = 8},/turf/open/floor/plasteel/showroomfloor,/area/awaymission/casino/security)
"XS" = (/obj/machinery/door/window/northright,/turf/open/floor/plasteel/showroomfloor,/area/awaymission/casino/security)
"Zw" = (/obj/structure/table/wood/poker,/turf/open/floor/wood,/area/awaymission/casino/pit)
"Zz" = (/obj/structure/railing{dir = 8},/turf/open/floor/wood,/area/awaymission/casino/lounge)

(1,1,1) = {"
lJlJlJlJlJlJlJlJlJlJlJlJlJlJlJlJlJlJlJlJlJlJlJlJlJlJlJlJlJlJlJlJlJlJlJlJlJlJlJlJlJlJlJlJlJlJlJlJlJlJ
lJlJlJlJlJlJlJlJlJlJlJlJlJlJlJlJlJlJlJlJlJlJlJlJlJlJlJlJlJlJlJlJlJlJlJlJlJlJlJlJlJlJlJlJlJlJlJlJlJlJ
lJlJlJlJlJlJlJlJlJlJlJlJlJlJlJlJlJlJlJlJlJlJlJlJlJlJlJlJlJlJlJlJlJlJlJlJlJlJlJlJlJlJlJlJlJlJlJlJlJlJ
lJlJlJlJlJlJlJlJlJlJlJlJlJlJlJlJlJlJlJlJlJlJlJlJlJlJlJlJlJlJlJlJlJlJlJlJlJlJlJlJlJlJlJlJlJlJlJlJlJlJ
lJlJlJlJlJlJlJlJlJlJlJlJlJlJlJlJlJlJlJlJlJlJlJlJlJlJlJlJlJlJlJlJlJlJlJlJlJlJlJlJlJlJlJlJlJlJlJlJlJlJ
lJlJlJlJlJlJlJlJlJlJlJlJlJlJlJlJlJlJlJlJlJlJlJlJlJlJlJlJlJlJlJlJlJlJlJlJlJlJlJlJlJlJlJlJlJlJlJlJlJlJ
lJlJlJlJlJlJlJlJlJlJlJlJlJlJlJlJlJlJlJlJlJlJlJlJlJlJlJlJlJlJlJlJlJlJlJlJlJlJlJlJlJlJlJlJlJlJlJlJlJlJ
lJlJlJlJlJlJlJlJlJlJlJlJlJlJlJlJlJlJlJlJlJlJlJlJlJlJlJlJlJlJlJlJlJlJlJlJlJlJlJlJlJlJlJlJlJlJlJlJlJlJ
lJlJlJlJlJlJlJlJlJlJlJlJlJlJlJlJlJlJlJlJlJlJlJlJlJlJlJlJlJlJlJlJlJlJlJlJlJlJlJlJlJlJlJlJlJlJlJlJlJlJ
lJlJlJlJlJlJlJlJlJlJlJlJlJlJlJlJlJlJlJlJlJlJlJlJlJlJlJlJlJlJlJlJlJlJlJlJlJlJlJlJlJlJlJlJlJlJlJlJlJlJ
lJlJlJlJlJlJlJlJlJlJlJlJlJlJlJlJlJlJlJlJlJlJlJlJlJlJlJlJlJlJlJlJlJlJlJlJlJlJlJlJlJlJlJlJlJlJlJlJlJlJ
lJlJlJlJlJlJlJlJlJlJlJlJlJlJlJlJlJlJlJlJlJlJlJlJlJlJlJlJlJlJlJlJlJlJlJlJlJlJlJlJlJlJlJlJlJlJlJlJlJlJ
lJlJlJlJlJlJlJlJlJlJlJlJlJlJlJlJlJlJlJlJlJlJlJlJlJlJlJlJlJlJlJlJlJlJlJlJlJlJlJlJlJlJlJlJlJlJlJlJlJlJ
lJlJlJlJlJlJlJlJlJlJlJlJlJlJlJlJlJlJlJlJlJlJlJlJlJlJlJlJlJlJlJlJlJlJlJlJlJlJlJlJlJlJlJlJlJlJlJlJlJlJ
lJlJlJlJlJlJlJlJlJlJlJlJlJlJlJlJlJlJlJlJlJlJlJlJlJlJlJlJlJlJlJlJlJlJlJlJlJlJlJlJlJlJlJlJlJlJlJlJlJlJ
lJlJlJlJlJlJlJlJlJlJlJlJlJlJlJlJlJlJlJlJlJlJlJlJlJlJlJlJlJlJlJlJlJlJlJlJlJlJlJlJlJlJlJlJlJlJlJlJlJlJ
lJlJlJlJlJlJlJlJlJlJlJlJlJlJlJlJlJlJnCnCnCnCnCnCnCnCnCnCnCnCnClJlJlJlJlJlJlJlJlJlJlJlJlJlJlJlJlJlJlJ
lJlJlJlJlJlJlJlJlJlJlJlJlJlJlJlJlJnCnCkykyBzBzBzBzBzBzFUFUFUnCnClJlJlJlJlJlJlJlJlJlJlJlJlJlJlJlJlJlJ
lJlJlJlJlJlJlJlJlJlJlJlJlJlJlJlJnCnCoZoZoZoZoZoZoZoZoZoZoZoZoZnCnClJlJlJlJlJlJlJlJlJlJlJlJlJlJlJlJlJ
lJlJlJlJlJlJlJlJlJlJlJlJlJlJlJlJnCoZoZoZoZoZQNQNiXiXQNQNoZoZoZoZnClJlJlJlJlJlJlJlJlJlJlJlJlJlJlJlJlJ
lJlJlJlJlJlJlJlJlJlJlJjKjKjKGGjKRrnCnCnCoRnCnCRrnCRrnCnCoRnCnCnCRrjKGGjKjKjKjKlJlJlJlJlJlJlJlJlJlJlJ
lJlJlJlJlJlJlJlJlJlJlJjKSLSLSLjQSLSLSLrXrXSLSLSLjQSLSLSLrXrXSLSLSLjQSLSLSLrXjKlJlJlJlJlJlJlJlJlJlJlJ
lJlJlJlJlJlJlJlJlJlJlJjKTFZwdUnedUZwqmrXzrOJZwdUnedUZwOJzrrXTFZwdUnedUZwqmHCjKlJlJlJlJlJlJlJlJlJlJlJ
lJlJlJlJlJlJlJlJlJlJlJjKgJZwneneneZwSLrXzrSLZwneneneZwSLzrrXSLZwneneneZwSLrXjKlJlJlJlJlJlJlJlJlJlJlJ
lJlJlJlJlJlJlJlJlJlJlJjKTFZwneQnneZwqmrXzrOJZwneQnneZwOJzrrXTFZwneQnneZwqmrXjKlJlJlJlJlJlJlJlJlJlJlJ
lJlJlJlJlJlJlJlJlJlJlJGGSLdUZwZwZwdUSLrXzrSLdUZwZwZwdUSLzrrXSLdUZwZwZwdUSLrXjKlJlJlJlJlJlJlJlJlJlJlJ
lJlJlJlJlJlJlJlJlJlJvUjKSLSLOOSLOOSLSLrXrXSLazOOSLOOSLSLrXrXSLSLOOSLOOSLazrXjKlJlJlJlJlJlJlJlJlJlJlJ
lJlJlJlJGHGHGHGHGHGHGHjKqxqxqxqxqxqxfurXqxqxjKqxqxqxqxqxqxqxqxNeNeNeqxqxjKqxjKlJlJlJlJlJlJlJlJlJlJlJ
lJlJlJlJGHIcIcIcIcIcIcIcIcIcIcIcIcIcIcIcWPUaKXIeHpyCQsedRseIIcIcIcIcIcIceydrGHlJlJlJlJlJlJlJlJlJlJlJ
lJlJlJlJLInBnBLILILILILILILIIcIcIyIyIcIcqKUKQeQeQeQeQeQeCaeIIcIcIyIyIcIcVrRhGHlJlJlJlJlJlJlJlJlJlJlJ
lJlJlJlJLIupupLIhTasastataLIIcIyaImrIyIcqKUKQeQeQeQeQeQeCaeIIcIyaImrIyIcwXGHGHlJlJlJlJlJlJlJlJlJlJlJ
lJlJlJlJLIupupjDniONONONONLIIcIysaaIIyIcqKUKEoEofLsHEoEoCaeIIcIysaaIIyHoGHGHlJlJlJlJlJlJlJlJlJlJlJlJ
lJlJlJlJLIupupdauJONONONONsLIcIcIyIyIcIcoMMoMoMoMoMoMoMoMoIKIcIcIyIyIcgBGHlJlJlJlJlJlJlJlJlJlJlJlJlJ
lJlJlJlJLIupupjDsnONLILILILILIabmymyIcIcVhVhVhVhVhVhVhVhVhVhIcIcmymyabGHGHlJlJlJlJlJlJlJlJlJlJlJlJlJ
lJlJlJlJLIupupLILIUOLIONONtULILIcUcUIcIcVhVhVhVhVhVhVhVhVhVhIcIccUcUucuclJlJlJlJlJlJlJlJlJlJlJlJlJlJ
lJlJlJlJLIupupCeONONKHONONONevLIGHGHabmymyoQWUsYsYsYsYILZzmymyabucucuclJlJlJlJlJlJlJlJlJlJlJlJlJlJlJ
lJlJlJlJLInBnBXiTpQtLILILILILILIlJGHGHcUcUoQVhVhVhVhVhVhZzcUcUucuclJlJlJlJlJlJlJlJlJlJlJlJlJlJlJlJlJ
lJlJlJlJLIupupupupupLIOMOMOMBWLIlJlJGHGHucucPnNXOUPnkVOUucucucuclJlJlJlJlJlJlJlJlJlJlJlJlJlJlJlJlJlJ
lJlJlJlJLIupupupupupupupupupOMLIlJlJlJlJlJucucucucucucucuclJlJlJlJlJlJlJlJlJlJlJlJlJlJlJlJlJlJlJlJlJ
lJlJlJlJLILILILILIupLIupupupOMLIlJlJlJlJlJlJlJlJlJlJlJlJlJlJlJlJlJlJlJlJlJlJlJlJlJlJlJlJlJlJlJlJlJlJ
lJlJlJlJLIfoVyXhuSXlWTupupupRHLIlJlJlJlJlJlJlJlJlJlJlJlJlJlJlJlJlJlJlJlJlJlJlJlJlJlJlJlJlJlJlJlJlJlJ
lJlJlJlJLIVyKmVyuSWDLIOMOMOMBWLIlJlJlJlJlJlJlJlJlJlJlJlJlJlJlJlJlJlJlJlJlJlJlJlJlJlJlJlJlJlJlJlJlJlJ
lJlJlJlJLIXhVyfouSVdzcLILILILILIlJlJlJlJlJlJlJlJlJlJlJlJlJlJlJlJlJlJlJlJlJlJlJlJlJlJlJlJlJlJlJlJlJlJ
lJlJlJlJLIuSuSuSuSXlLIlJlJlJlJlJlJlJlJlJlJlJlJlJlJlJlJlJlJlJlJlJlJlJlJlJlJlJlJlJlJlJlJlJlJlJlJlJlJlJ
lJlJlJlJLIGESVXSGEcNqQlJlJlJlJlJlJlJlJlJlJlJlJlJlJlJlJlJlJlJlJlJlJlJlJlJlJlJlJlJlJlJlJlJlJlJlJlJlJlJ
lJlJlJlJLILILILILILILIlJlJlJlJlJlJlJlJlJlJlJlJlJlJlJlJlJlJlJlJlJlJlJlJlJlJlJlJlJlJlJlJlJlJlJlJlJlJlJ
lJlJlJlJlJlJlJlJlJlJlJlJlJlJlJlJlJlJlJlJlJlJlJlJlJlJlJlJlJlJlJlJlJlJlJlJlJlJlJlJlJlJlJlJlJlJlJlJlJlJ
lJlJlJlJlJlJlJlJlJlJlJlJlJlJlJlJlJlJlJlJlJlJlJlJlJlJlJlJlJlJlJlJlJlJlJlJlJlJlJlJlJlJlJlJlJlJlJlJlJlJ
lJlJlJlJlJlJlJlJlJlJlJlJlJlJlJlJlJlJlJlJlJlJlJlJlJlJlJlJlJlJlJlJlJlJlJlJlJlJlJlJlJlJlJlJlJlJlJlJlJlJ
lJlJlJlJlJlJlJlJlJlJlJlJlJlJlJlJlJlJlJlJlJlJlJlJlJlJlJlJlJlJlJlJlJlJlJlJlJlJlJlJlJlJlJlJlJlJlJlJlJlJ
"}
