"ai" = (/obj/structure/mineral_door/wood,/obj/effect/decal/cleanable/blood/gibs/torso,/obj/effect/decal/cleanable/blood/tracks{dir = 4},/turf/open/floor/wood,/area/whitesands/surface/outdoors/unexplored)
"dd" = (/obj/structure/barricade/wooden,/obj/structure/mineral_door/wood,/obj/effect/decal/cleanable/blood,/obj/effect/decal/cleanable/blood/tracks,/turf/open/floor/wood,/area/whitesands/surface/outdoors/unexplored)
"dx" = (/obj/item/storage/pill_bottle/charcoal,/obj/item/storage/pill_bottle/stimulant{pixel_x = -3; pixel_y = 3},/obj/item/rack_parts,/turf/open/floor/wood,/area/whitesands/surface/outdoors/unexplored)
"eq" = (/obj/structure/table/wood,/turf/open/floor/wood{icon_state = "wood-broken7"},/area/whitesands/surface/outdoors/unexplored)
"fU" = (/obj/structure/table/wood,/obj/item/chainsaw,/obj/effect/decal/cleanable/blood,/obj/effect/decal/cleanable/blood/gibs/bubblegum,/obj/effect/decal/cleanable/blood/gibs/body,/obj/item/toy/cattoy,/obj/effect/decal/cleanable/blood/gibs/torso,/turf/open/floor/wood,/area/whitesands/surface/outdoors/unexplored)
"hb" = (/turf/template_noop,/area/template_noop)
"ie" = (/obj/item/reagent_containers/pill/cyanide,/turf/open/floor/wood,/area/whitesands/surface/outdoors/unexplored)
"kh" = (/obj/structure/rack,/turf/open/floor/wood,/area/whitesands/surface/outdoors/unexplored)
"kL" = (/obj/structure/rack,/obj/item/storage/firstaid/o2{pixel_x = -3; pixel_y = 3},/obj/item/storage/firstaid/toxin,/obj/effect/decal/cleanable/blood/gibs/core,/turf/open/floor/wood,/area/whitesands/surface/outdoors/unexplored)
"lc" = (/obj/item/shard{icon_state = "tiny"},/obj/item/shard{icon_state = "medium"},/turf/open/floor/plating,/area/whitesands/surface/outdoors/unexplored)
"le" = (/obj/structure/closet/secure_closet/medical1,/turf/open/floor/wood,/area/whitesands/surface/outdoors/unexplored)
"lh" = (/obj/effect/decal/cleanable/blood/old,/obj/effect/decal/cleanable/blood/tracks,/turf/open/floor/wood,/area/whitesands/surface/outdoors/unexplored)
"ll" = (/obj/structure/table/wood,/obj/item/scalpel,/obj/item/hemostat,/obj/item/cautery,/obj/effect/decal/cleanable/blood,/obj/effect/decal/cleanable/blood/gibs,/turf/open/floor/wood,/area/whitesands/surface/outdoors/unexplored)
"mf" = (/obj/effect/spawner/lootdrop/minor/kittyears_or_rabbitears,/obj/effect/decal/cleanable/blood/old,/obj/item/gun/syringe,/turf/open/floor/wood,/area/whitesands/surface/outdoors/unexplored)
"mI" = (/obj/structure/rack,/obj/item/storage/pill_bottle/penacid{pixel_x = 3; pixel_y = -3},/turf/open/floor/wood,/area/whitesands/surface/outdoors/unexplored)
"nW" = (/obj/effect/decal/cleanable/blood,/obj/effect/mob_spawn/human/corpse/damaged{head = /obj/item/clothing/head/kitty},/obj/item/restraints/handcuffs,/turf/open/floor/wood,/area/whitesands/surface/outdoors/unexplored)
"oF" = (/obj/structure/table/wood,/turf/open/floor/wood,/area/whitesands/surface/outdoors/unexplored)
"qz" = (/obj/structure/bed,/obj/item/bedsheet/dorms,/obj/structure/curtain,/obj/machinery/iv_drip,/obj/item/organ/tail/cat,/obj/effect/decal/cleanable/blood/tracks{dir = 4},/obj/effect/decal/cleanable/blood/tracks{dir = 4},/turf/open/floor/wood,/area/whitesands/surface/outdoors/unexplored)
"qC" = (/obj/effect/spawner/lootdrop/donkpockets,/obj/item/rack_parts,/turf/open/floor/wood,/area/whitesands/surface/outdoors/unexplored)
"qN" = (/obj/effect/decal/cleanable/blood/tracks{dir = 4},/mob/living/simple_animal/hostile/cat_butcherer{desc = "Has gone mad after "the collaspe" and is now searching for a mythical race."},/obj/effect/decal/cleanable/blood/gibs/limb,/turf/open/floor/wood,/area/whitesands/surface/outdoors/unexplored)
"uT" = (/obj/structure/closet/cabinet,/obj/item/reagent_containers/glass/bottle/bromine,/obj/item/reagent_containers/glass/bottle/aluminium,/obj/item/reagent_containers/glass/bottle/chlorine,/obj/item/reagent_containers/glass/bottle/carbon,/obj/item/reagent_containers/glass/bottle/ethanol,/obj/item/reagent_containers/glass/bottle/copper,/obj/item/reagent_containers/glass/bottle/water,/obj/item/reagent_containers/glass/bottle/hydrogen,/obj/item/reagent_containers/glass/bottle/fluorine,/obj/item/reagent_containers/glass/bottle/lithium,/obj/item/reagent_containers/glass/bottle/iron,/obj/item/reagent_containers/glass/bottle/iodine,/obj/item/reagent_containers/glass/bottle/phosphorus,/obj/item/reagent_containers/glass/bottle/nitrogen,/obj/item/reagent_containers/glass/bottle/mercury,/obj/item/reagent_containers/glass/bottle/oxygen,/obj/item/reagent_containers/glass/bottle/nitrogen,/obj/item/reagent_containers/glass/bottle/welding_fuel,/obj/item/reagent_containers/glass/bottle/potassium,/obj/item/reagent_containers/glass/bottle/radium,/obj/item/reagent_containers/glass/bottle/sodium,/obj/item/reagent_containers/glass/bottle/silver,/obj/item/reagent_containers/glass/bottle/sulfur,/obj/item/reagent_containers/glass/bottle/sugar,/turf/open/floor/wood,/area/whitesands/surface/outdoors/unexplored)
"vm" = (/obj/item/organ/ears/cat,/obj/item/organ/tail/cat,/obj/effect/decal/cleanable/blood/gibs/old,/obj/effect/decal/cleanable/blood/tracks,/mob/living/simple_animal/pet/cat/kitten{desc = "Has seen horrors beyond imagination. Seems to be unfazed."; name = "Lisa"},/turf/open/floor/wood,/area/whitesands/surface/outdoors/unexplored)
"vw" = (/obj/effect/spawner/lootdrop/minor/kittyears_or_rabbitears,/obj/effect/decal/cleanable/blood/old,/obj/effect/decal/cleanable/dirt,/turf/open/floor/wood,/area/whitesands/surface/outdoors/unexplored)
"vP" = (/obj/effect/decal/cleanable/blood/old,/obj/effect/decal/cleanable/dirt,/turf/open/floor/wood,/area/whitesands/surface/outdoors/unexplored)
"vR" = (/obj/structure/bed,/obj/item/bedsheet/dorms,/obj/structure/curtain,/obj/machinery/iv_drip,/obj/item/organ/ears/cat,/obj/effect/mob_spawn/human/corpse/damaged{head = /obj/item/clothing/head/kitty},/turf/open/floor/wood,/area/whitesands/surface/outdoors/unexplored)
"wr" = (/obj/item/melee/baton/cattleprod,/turf/open/floor/wood,/area/whitesands/surface/outdoors/unexplored)
"wC" = (/obj/effect/decal/cleanable/blood/old,/obj/effect/decal/cleanable/blood/old,/obj/effect/decal/cleanable/dirt,/turf/open/floor/wood,/area/whitesands/surface/outdoors/unexplored)
"wD" = (/obj/structure/closet/secure_closet/medical3,/obj/effect/decal/cleanable/dirt,/turf/open/floor/wood,/area/whitesands/surface/outdoors/unexplored)
"xb" = (/obj/structure/table/wood,/obj/item/screwdriver/old,/obj/item/organ/ears/cat,/obj/item/organ/ears/cat{pixel_x = 5; pixel_y = -2},/obj/effect/decal/cleanable/blood,/obj/item/clothing/gloves/color/latex,/obj/item/organ/tail/cat{pixel_x = -6; pixel_y = 3},/obj/item/organ/tail/cat{pixel_x = 1; pixel_y = -5},/obj/effect/decal/cleanable/blood/gibs/body,/obj/effect/decal/cleanable/blood/gibs/torso,/turf/open/floor/wood,/area/whitesands/surface/outdoors/unexplored)
"xQ" = (/turf/open/floor/plating,/area/whitesands/surface/outdoors/unexplored)
"yl" = (/obj/effect/spawner/lootdrop/minor/kittyears_or_rabbitears,/obj/item/rack_parts,/obj/item/shard{icon_state = "small"},/turf/open/floor/wood,/area/whitesands/surface/outdoors/unexplored)
"yQ" = (/obj/item/reagent_containers/pill/trophazole,/obj/effect/decal/cleanable/dirt,/turf/open/floor/wood{icon_state = "wood-broken7"},/area/whitesands/surface/outdoors/unexplored)
"yZ" = (/obj/effect/decal/cleanable/dirt,/turf/open/floor/wood,/area/whitesands/surface/outdoors/unexplored)
"zu" = (/obj/effect/spawner/structure/window,/turf/open/floor/plating,/area/whitesands/surface/outdoors/unexplored)
"zL" = (/obj/structure/rack,/obj/effect/spawner/lootdrop/donkpockets,/turf/open/floor/wood,/area/whitesands/surface/outdoors/unexplored)
"Ak" = (/obj/item/shard{icon_state = "tiny"},/obj/item/shard,/turf/open/floor/plating,/area/whitesands/surface/outdoors/unexplored)
"BZ" = (/turf/closed/wall/rust,/area/whitesands/surface/outdoors/unexplored)
"Cn" = (/obj/structure/girder/displaced,/turf/open/floor/plating,/area/whitesands/surface/outdoors/unexplored)
"CE" = (/obj/item/reagent_containers/pill/patch/styptic{pixel_x = 3; pixel_y = -3},/obj/item/reagent_containers/pill/patch/styptic,/obj/item/reagent_containers/pill/patch/styptic{pixel_x = -3; pixel_y = 3},/obj/item/rack_parts,/turf/open/floor/wood,/area/whitesands/surface/outdoors/unexplored)
"EA" = (/obj/machinery/door/window/northleft{dir = 4},/obj/effect/decal/cleanable/dirt,/turf/open/floor/wood,/area/whitesands/surface/outdoors/unexplored)
"EN" = (/obj/structure/rack,/obj/item/reagent_containers/pill/patch/synthflesh{pixel_x = -3; pixel_y = 3},/turf/open/floor/wood,/area/whitesands/surface/outdoors/unexplored)
"ET" = (/obj/effect/decal/cleanable/dirt,/turf/open/floor/wood{icon_state = "wood-broken6"},/area/whitesands/surface/outdoors/unexplored)
"Gl" = (/obj/effect/decal/cleanable/dirt,/turf/open/floor/wood{icon_state = "wood-broken7"},/area/whitesands/surface/outdoors/unexplored)
"Gu" = (/obj/structure/table/wood,/obj/effect/decal/cleanable/blood/old,/turf/open/floor/wood,/area/whitesands/surface/outdoors/unexplored)
"GD" = (/obj/structure/rack,/obj/item/organ/ears/cat,/obj/item/organ/tail/cat,/obj/effect/spawner/lootdrop/minor/kittyears_or_rabbitears,/obj/effect/decal/cleanable/dirt,/turf/open/floor/wood,/area/whitesands/surface/outdoors/unexplored)
"Hb" = (/obj/effect/mob_spawn/human/corpse/damaged{head = /obj/item/clothing/head/kitty},/turf/open/floor/wood,/area/whitesands/surface/outdoors/unexplored)
"HK" = (/obj/structure/rack,/obj/item/storage/firstaid/advanced{pixel_x = -3; pixel_y = 3},/obj/item/storage/firstaid/brute,/obj/item/storage/firstaid/fire{pixel_x = 3; pixel_y = -3},/obj/effect/decal/cleanable/blood,/turf/open/floor/wood,/area/whitesands/surface/outdoors/unexplored)
"Ix" = (/turf/open/floor/wood{icon_state = "wood-broken5"},/area/whitesands/surface/outdoors/unexplored)
"Jq" = (/obj/structure/girder,/turf/open/floor/plating,/area/whitesands/surface/outdoors/unexplored)
"JJ" = (/obj/structure/bed,/obj/item/bedsheet/dorms,/obj/structure/curtain,/obj/machinery/iv_drip,/obj/item/organ/ears/cat,/obj/item/organ/tail/cat,/obj/effect/decal/cleanable/blood/gibs/torso,/obj/effect/decal/cleanable/blood/tracks{dir = 4},/obj/effect/mob_spawn/human/corpse/damaged{head = /obj/item/clothing/head/kitty},/turf/open/floor/wood,/area/whitesands/surface/outdoors/unexplored)
"JK" = (/obj/effect/decal/cleanable/dirt,/turf/open/floor/wood{icon_state = "wood-broken5"},/area/whitesands/surface/outdoors/unexplored)
"Kz" = (/obj/structure/mineral_door/wood,/turf/open/floor/wood,/area/whitesands/surface/outdoors/unexplored)
"LD" = (/obj/structure/table/wood,/obj/effect/decal/cleanable/dirt,/turf/open/floor/wood,/area/whitesands/surface/outdoors/unexplored)
"Nf" = (/obj/structure/closet/secure_closet/chemical,/obj/machinery/light,/turf/open/floor/wood,/area/whitesands/surface/outdoors/unexplored)
"NZ" = (/obj/structure/barricade/wooden,/obj/effect/decal/cleanable/blood/tracks{dir = 4},/turf/open/floor/wood,/area/whitesands/surface/outdoors/unexplored)
"OS" = (/turf/closed/wall,/area/whitesands/surface/outdoors/unexplored)
"PB" = (/obj/effect/decal/cleanable/blood/gibs/limb,/turf/open/floor/wood,/area/whitesands/surface/outdoors/unexplored)
"Qb" = (/obj/item/shard{icon_state = "tiny"},/obj/item/shard{icon_state = "small"},/turf/open/floor/plating,/area/whitesands/surface/outdoors/unexplored)
"Qx" = (/obj/effect/decal/cleanable/blood,/obj/item/melee/baton/cattleprod,/turf/open/floor/wood,/area/whitesands/surface/outdoors/unexplored)
"Rj" = (/obj/structure/table/wood,/obj/item/paper_bin,/obj/item/pen,/turf/open/floor/wood,/area/whitesands/surface/outdoors/unexplored)
"Sa" = (/obj/effect/decal/cleanable/blood,/turf/open/floor/wood,/area/whitesands/surface/outdoors/unexplored)
"Sm" = (/obj/structure/rack,/obj/effect/spawner/lootdrop/minor/kittyears_or_rabbitears,/obj/effect/decal/cleanable/dirt,/turf/open/floor/wood,/area/whitesands/surface/outdoors/unexplored)
"Sy" = (/obj/effect/decal/cleanable/blood/old,/obj/effect/decal/cleanable/dirt,/turf/open/floor/wood{icon_state = "wood-broken5"},/area/whitesands/surface/outdoors/unexplored)
"SI" = (/obj/structure/rack,/obj/effect/spawner/lootdrop/minor/kittyears_or_rabbitears,/turf/open/floor/wood{icon_state = "wood-broken5"},/area/whitesands/surface/outdoors/unexplored)
"SM" = (/obj/structure/sign/departments/medbay,/turf/closed/wall,/area/whitesands/surface/outdoors/unexplored)
"SQ" = (/obj/effect/spawner/lootdrop/minor/kittyears_or_rabbitears,/obj/effect/decal/cleanable/blood/old,/turf/open/floor/wood,/area/whitesands/surface/outdoors/unexplored)
"Tu" = (/obj/machinery/chem_master,/turf/open/floor/wood,/area/whitesands/surface/outdoors/unexplored)
"Us" = (/obj/structure/table/wood,/obj/item/clothing/glasses/hud/health,/turf/open/floor/wood,/area/whitesands/surface/outdoors/unexplored)
"Ux" = (/obj/structure/table/wood,/obj/item/storage/toolbox/mechanical/old/clean,/obj/effect/decal/cleanable/blood,/obj/effect/decal/cleanable/blood/gibs/bubblegum,/turf/open/floor/wood,/area/whitesands/surface/outdoors/unexplored)
"VA" = (/obj/structure/table/optable,/obj/effect/decal/cleanable/blood,/obj/effect/mob_spawn/human/corpse/damaged{head = /obj/item/clothing/head/kitty},/obj/item/restraints/handcuffs,/turf/open/floor/wood,/area/whitesands/surface/outdoors/unexplored)
"VW" = (/obj/structure/bed,/obj/item/bedsheet/dorms,/obj/structure/curtain,/obj/machinery/iv_drip,/obj/item/organ/ears/cat,/turf/open/floor/wood,/area/whitesands/surface/outdoors/unexplored)
"Wl" = (/obj/structure/closet/secure_closet/medical2,/obj/effect/decal/cleanable/blood,/obj/effect/decal/cleanable/blood/gibs/up,/obj/effect/decal/cleanable/blood/gibs/torso,/obj/item/organ/eyes/robotic/xray,/turf/open/floor/wood,/area/whitesands/surface/outdoors/unexplored)
"WW" = (/turf/open/floor/wood,/area/whitesands/surface/outdoors/unexplored)
"Zm" = (/turf/open/floor/wood{icon_state = "wood-broken6"},/area/whitesands/surface/outdoors/unexplored)
"Zo" = (/obj/structure/table/wood,/obj/item/storage/firstaid/regular{empty = 1; name = "First-Aid (empty)"},/turf/open/floor/wood,/area/whitesands/surface/outdoors/unexplored)

(1,1,1) = {"
CnzulcJqKzSMJqQbAkBZxQ
JqSmylSmWWSIWWmIdxqCOS
xQieyQIxWWZmyZWWIxzLxQ
xQeqRjoFZoUsoFSyIxCEBZ
JqTuyZIxvPyZLDvwvPkhOS
BZGDETETGlJKGuvPmfENJq
JqlewDNfuTWWEASQwClhxQ
xQOSBZBZBZOSBZOSBZddCn
OSllfUSaHbHbBZvRVWvmBZ
BZVASaQxWWqNaiNZJJqzOS
BZUxxbWWnWwrOSOSBZOSBZ
OSWlPBHbHKkLBZhbhbhbhb
CnOSBZBZOSBZOShbhbhbhb
"}
