"a" = (/turf/template_noop,/area/template_noop)
"d" = (/turf/open/floor/plating/asteroid/whitesands/dried,/area/template_noop)
"o" = (/mob/living/simple_animal/hostile/whitesands/survivor,/turf/open/floor/plating/asteroid/whitesands,/area/template_noop)
"s" = (/obj/structure/closet/crate/grave,/turf/open/floor/plating/asteroid/whitesands,/area/template_noop)
"x" = (/obj/structure/bonfire/prelit,/turf/open/floor/plating/asteroid/whitesands,/area/template_noop)
"y" = (/obj/structure/chair/plastic{dir = 8},/turf/open/floor/plating/asteroid/whitesands/dried,/area/template_noop)
"G" = (/turf/open/floor/plating/asteroid/whitesands,/area/template_noop)
"H" = (/mob/living/simple_animal/hostile/whitesands/ranged/hunter,/turf/open/floor/plating/asteroid/whitesands,/area/template_noop)
"J" = (/obj/structure/chair/plastic,/turf/open/floor/plating/asteroid/whitesands,/area/template_noop)
"P" = (/mob/living/simple_animal/hostile/whitesands/survivor,/turf/open/floor/plating/asteroid/whitesands/dried,/area/template_noop)
"S" = (/obj/effect/spawner/lootdrop/whitesands/survivor,/turf/open/floor/plating/asteroid/whitesands/dried,/area/template_noop)

(1,1,1) = {"
aaaaaaaaaaaa
aaGaaaaaaaaa
aaGaadadGGGa
aaGddddPddaa
aaGdJGGdGsaa
aaGdoxdSdaaa
aadddGyddaaa
aadGSGHddaaa
aaaGddGGaaaa
aaaGGdGaaaaa
aaaGaaaaaaaa
aaaaaaaaaaaa
"}
