"a" = (/turf/template_noop,/area/template_noop)
"d" = (/turf/open/floor/plating/asteroid/whitesands/dried,/area/template_noop)
"o" = (/mob/living/simple_animal/hostile/whitesands/ranged/hunter,/turf/open/floor/plating/asteroid/whitesands,/area/template_noop)
"s" = (/obj/structure/bed/roller{color = "#4B5320"},/turf/open/floor/plating/asteroid/whitesands/dried,/area/template_noop)
"x" = (/obj/effect/spawner/lootdrop/whitesands/survivor,/turf/open/floor/plating/asteroid/whitesands,/area/template_noop)
"y" = (/mob/living/simple_animal/hostile/whitesands/survivor,/turf/open/floor/plating/asteroid/whitesands,/area/template_noop)
"G" = (/turf/open/floor/plating/asteroid/whitesands,/area/template_noop)
"H" = (/obj/effect/mob_spawn/human/corpse/charredskeleton,/turf/open/floor/plating/asteroid/whitesands/dried,/area/template_noop)
"J" = (/obj/structure/bonfire/prelit,/turf/open/floor/plating/asteroid/whitesands/dried,/area/template_noop)

(1,1,1) = {"
aaaaaaaaaaaa
aaaaaaaaaaaa
aaaGaaGdaaaa
aaGGGGGdaaaa
aGGoGGsdaaaa
aaGGGxGGaaaa
aaGyHJGGaaaa
aGxdddGoGGaa
aGdddGadGGaa
aGaaaaaddGaa
aaaaaaaaaaaa
aaaaaaaaaaaa
"}
