"a" = (/obj/structure/fence/corner{dir = 8},/turf/template_noop,/area/whitesands/surface/outdoors)
"b" = (/obj/structure/fence/door/opened,/turf/template_noop,/area/whitesands/surface/outdoors)
"c" = (/obj/structure/fence,/turf/template_noop,/area/whitesands/surface/outdoors)
"d" = (/obj/machinery/light,/obj/effect/decal/cleanable/dirt,/turf/open/floor/wood{icon_state = "wood-broken5"},/area/whitesands/surface/outdoors/unexplored)
"e" = (/obj/item/shard{icon_state = "tiny"},/obj/item/shard{icon_state = "small"},/obj/effect/decal/cleanable/dirt,/turf/open/floor/plating,/area/whitesands/surface/outdoors/unexplored)
"f" = (/obj/item/shard{icon_state = "tiny"},/obj/item/shard{icon_state = "medium"},/obj/effect/decal/cleanable/dirt,/turf/open/floor/plating,/area/whitesands/surface/outdoors/unexplored)
"h" = (/obj/structure/closet/secure_closet/hydroponics,/obj/item/circuitboard/machine/plantgenes,/obj/item/gun/ballistic/rifle/boltaction/polymer,/turf/open/floor/wood,/area/whitesands/surface/outdoors/unexplored)
"i" = (/obj/machinery/hydroponics/soil,/turf/open/floor/plating/asteroid/whitesands/dried,/area/whitesands/surface/outdoors/unexplored)
"j" = (/obj/structure/table/wood,/obj/item/watertank,/obj/effect/decal/cleanable/dirt,/turf/open/floor/wood{icon_state = "wood-broken7"},/area/whitesands/surface/outdoors/unexplored)
"k" = (/obj/machinery/hydroponics/soil,/obj/item/cultivator/rake,/turf/open/floor/plating/asteroid/whitesands/dried,/area/whitesands/surface/outdoors/unexplored)
"l" = (/turf/open/floor/plating/asteroid/whitesands/dried,/area/whitesands/surface/outdoors/unexplored)
"m" = (/obj/machinery/chem_master/condimaster,/obj/effect/decal/cleanable/dirt,/turf/open/floor/wood,/area/whitesands/surface/outdoors/unexplored)
"n" = (/obj/effect/decal/cleanable/dirt,/turf/open/floor/wood{icon_state = "wood-broken7"},/area/whitesands/surface/outdoors/unexplored)
"o" = (/obj/structure/closet/crate/hydroponics,/obj/item/seeds/apple,/obj/item/seeds/banana,/obj/item/seeds/berry,/obj/item/seeds/cabbage,/obj/item/seeds/carrot,/obj/item/seeds/chili,/obj/item/seeds/cherry,/obj/item/seeds/cocoapod,/obj/item/seeds/cotton,/obj/item/seeds/corn,/obj/item/seeds/garlic,/obj/item/seeds/eggplant,/obj/item/seeds/orange,/obj/item/seeds/onion,/obj/item/seeds/lemon,/obj/item/seeds/lime,/obj/item/seeds/pineapple,/obj/item/seeds/potato,/obj/item/seeds/pumpkin,/obj/item/seeds/sugarcane,/obj/item/seeds/tea,/obj/item/seeds/tobacco,/obj/item/seeds/tomato,/obj/item/seeds/wheat,/obj/item/seeds/watermelon,/obj/effect/decal/cleanable/dirt,/turf/open/floor/wood,/area/whitesands/surface/outdoors/unexplored)
"p" = (/obj/item/ammo_box/aac_300blk_stripper,/turf/open/floor/wood,/area/whitesands/surface/outdoors/unexplored)
"r" = (/turf/open/floor/wood,/area/whitesands/surface/outdoors/unexplored)
"s" = (/obj/effect/decal/cleanable/dirt,/turf/open/floor/wood,/area/whitesands/surface/outdoors/unexplored)
"t" = (/obj/effect/decal/cleanable/dirt,/turf/open/floor/wood{icon_state = "wood-broken6"},/area/whitesands/surface/outdoors/unexplored)
"u" = (/obj/structure/chair/plastic{dir = 4},/obj/effect/decal/cleanable/dirt,/turf/open/floor/wood{icon_state = "wood-broken5"},/area/whitesands/surface/outdoors/unexplored)
"v" = (/obj/structure/fence/cut/large,/turf/template_noop,/area/whitesands/surface/outdoors)
"w" = (/obj/machinery/light,/turf/open/floor/wood,/area/whitesands/surface/outdoors/unexplored)
"z" = (/obj/structure/fence/cut/medium,/turf/template_noop,/area/whitesands/surface/outdoors)
"A" = (/obj/structure/chair/plastic{dir = 8},/obj/effect/decal/cleanable/dirt,/obj/effect/decal/remains/human,/obj/effect/decal/cleanable/blood/old,/turf/open/floor/wood,/area/whitesands/surface/outdoors/unexplored)
"B" = (/obj/machinery/hydroponics/soil,/obj/item/shovel,/turf/open/floor/plating/asteroid/whitesands/dried,/area/whitesands/surface/outdoors/unexplored)
"C" = (/obj/structure/mineral_door/wood,/turf/open/floor/wood,/area/whitesands/surface/outdoors/unexplored)
"D" = (/obj/machinery/door/window/northleft,/obj/item/circuitboard/machine/seed_extractor,/obj/structure/frame/machine,/obj/item/stack/cable_coil/cut/red,/turf/open/floor/wood,/area/whitesands/surface/outdoors/unexplored)
"E" = (/obj/structure/fence/cut/large{dir = 8},/turf/template_noop,/area/whitesands/surface/outdoors)
"F" = (/obj/machinery/biogenerator,/obj/machinery/door/window/northleft,/turf/open/floor/wood,/area/whitesands/surface/outdoors/unexplored)
"G" = (/obj/structure/sign/departments/botany,/turf/closed/wall/mineral/wood,/area/whitesands/surface/outdoors/unexplored)
"H" = (/obj/structure/bed,/obj/item/bedsheet/dorms,/turf/open/floor/wood,/area/whitesands/surface/outdoors/unexplored)
"I" = (/obj/item/shard{icon_state = "tiny"},/obj/item/shard,/obj/item/shard{icon_state = "small"},/obj/effect/decal/cleanable/dirt,/turf/open/floor/plating,/area/whitesands/surface/outdoors/unexplored)
"J" = (/obj/item/shard{icon_state = "tiny"},/obj/item/shard{icon_state = "small"},/turf/open/floor/plating,/area/whitesands/surface/outdoors/unexplored)
"K" = (/obj/structure/table/wood,/obj/item/gun/energy/floragun,/obj/item/storage/bag/plants/portaseeder,/obj/effect/decal/cleanable/dirt,/turf/open/floor/wood,/area/whitesands/surface/outdoors/unexplored)
"L" = (/turf/closed/wall/mineral/wood,/area/whitesands/surface/outdoors/unexplored)
"M" = (/obj/structure/fence/post,/turf/template_noop,/area/whitesands/surface/outdoors)
"N" = (/obj/structure/fence/post{dir = 1},/turf/template_noop,/area/whitesands/surface/outdoors)
"O" = (/obj/structure/fence/corner,/turf/template_noop,/area/whitesands/surface/outdoors)
"Q" = (/obj/structure/table/wood,/obj/machinery/reagentgrinder,/obj/effect/decal/cleanable/dirt,/turf/open/floor/wood{icon_state = "wood-broken5"},/area/whitesands/surface/outdoors/unexplored)
"R" = (/obj/effect/decal/cleanable/dirt,/turf/open/floor/wood{icon_state = "wood-broken5"},/area/whitesands/surface/outdoors/unexplored)
"S" = (/obj/item/shard{icon_state = "tiny"},/obj/item/shard{icon_state = "medium"},/obj/item/shard,/obj/effect/decal/cleanable/dirt,/turf/open/floor/plating,/area/whitesands/surface/outdoors/unexplored)
"T" = (/obj/effect/decal/cleanable/dirt,/obj/machinery/light{dir = 4},/turf/open/floor/wood{icon_state = "wood-broken5"},/area/whitesands/surface/outdoors/unexplored)
"U" = (/obj/structure/fence{dir = 8},/turf/template_noop,/area/whitesands/surface/outdoors)
"V" = (/obj/structure/closet/wardrobe/botanist,/turf/open/floor/wood,/area/whitesands/surface/outdoors/unexplored)
"W" = (/obj/structure/reagent_dispensers/watertank/high,/turf/open/floor/plating/asteroid/whitesands/dried,/area/whitesands/surface/outdoors/unexplored)
"X" = (/obj/structure/table/wood,/obj/item/reagent_containers/glass/bucket,/obj/item/reagent_containers/spray/weedspray{pixel_x = 7},/obj/effect/decal/cleanable/dirt,/turf/open/floor/wood,/area/whitesands/surface/outdoors/unexplored)
"Y" = (/obj/item/shard{icon_state = "tiny"},/obj/item/shard{icon_state = "medium"},/obj/item/shard,/obj/item/shard{icon_state = "small"},/obj/effect/decal/cleanable/dirt,/turf/open/floor/plating,/area/whitesands/surface/outdoors/unexplored)
"Z" = (/obj/structure/fence{dir = 8},/obj/structure/fence{dir = 8},/turf/template_noop,/area/whitesands/surface/outdoors)

(1,1,1) = {"
LLISSLLLLLL
YsRstsLVhHL
LuQmoTLprwL
LsjKXALLCLL
JnsdsnstsRf
LIeLDFLGCLL
NWllllllllM
clklBlillic
vlililillic
zlililillic
clililillic
clililillic
clllllllllc
aEUUUUUUbZO
"}
