"a" = (/turf/template_noop,/area/template_noop)
"d" = (/turf/open/floor/plating/asteroid/whitesands/dried,/area/template_noop)
"s" = (/obj/structure/bed/roller{color = "#4B5320"},/turf/open/floor/plating/asteroid/whitesands,/area/template_noop)
"x" = (/mob/living/simple_animal/hostile/whitesands/ranged/gunslinger,/turf/open/floor/plating/asteroid/whitesands,/area/template_noop)
"y" = (/obj/structure/bonfire/prelit,/turf/open/floor/plating/asteroid/whitesands,/area/template_noop)
"G" = (/turf/open/floor/plating/asteroid/whitesands,/area/template_noop)
"H" = (/mob/living/simple_animal/hostile/whitesands/ranged/hunter,/turf/open/floor/plating/asteroid/whitesands,/area/template_noop)
"J" = (/turf/closed/mineral/random/whitesands,/area/template_noop)
"S" = (/mob/living/simple_animal/hostile/whitesands/ranged/gunslinger,/turf/open/floor/plating/asteroid/whitesands/dried,/area/template_noop)

(1,1,1) = {"
aaaaaaaaaaaa
aaaaaaaaaaaa
aaaaaaaaaaaa
aaaJddaaaaaa
aaJJJsdaaaaa
aadJJGxddaaa
aadGJyGGdaaa
aaadSdHGdaaa
aaaaadGdaaaa
aaaaaadddaaa
aaaaaaaaaaaa
aaaaaaaaaaaa
"}
