"a" = (/turf/template_noop,/area/template_noop)
"c" = (/obj/machinery/mineral/equipment_vendor,/turf/open/floor/plating/asteroid/whitesands/dried,/area/template_noop)
"g" = (/turf/open/floor/plating/asteroid/whitesands/dried,/area/template_noop)
"i" = (/obj/item/stack/sheet/mineral/gold/five,/obj/structure/table,/turf/open/floor/plating/asteroid/whitesands/dried,/area/template_noop)
"n" = (/obj/structure/table,/obj/item/ammo_box/aac_300blk_stripper,/obj/item/ammo_box/aac_300blk_stripper,/turf/open/floor/plating/asteroid/whitesands/dried,/area/template_noop)
"p" = (/obj/structure/table,/obj/item/gun/ballistic/automatic/aks74u,/obj/item/ammo_box/magazine/aks74u,/obj/item/ammo_box/magazine/aks74u,/turf/open/floor/plating/asteroid/whitesands/dried,/area/template_noop)
"r" = (/turf/closed/wall/mineral/sandstone,/area/template_noop)
"s" = (/obj/structure/mineral_door/sandstone,/turf/open/floor/plating/asteroid/whitesands/dried,/area/template_noop)
"u" = (/obj/structure/falsewall/sandstone,/turf/open/floor/plating/asteroid/whitesands/dried,/area/template_noop)
"v" = (/obj/item/stack/sheet/mineral/uranium/five,/obj/structure/table,/turf/open/floor/plating/asteroid/whitesands/dried,/area/template_noop)
"y" = (/obj/structure/table,/obj/item/radio,/obj/item/radio,/obj/item/radio,/turf/open/floor/plating/asteroid/whitesands/dried,/area/template_noop)
"B" = (/turf/open/floor/plating/asteroid/whitesands,/area/template_noop)
"E" = (/obj/machinery/hydroponics/soil,/turf/open/floor/plating/asteroid/whitesands/dried,/area/template_noop)
"I" = (/mob/living/simple_animal/hostile/whitesands/ranged/hunter,/turf/open/floor/plating/asteroid/whitesands/dried,/area/template_noop)
"K" = (/obj/structure/reagent_dispensers/watertank,/turf/open/floor/plating/asteroid/whitesands/dried,/area/template_noop)
"L" = (/obj/structure/barricade/sandbags,/turf/open/floor/plating/asteroid/whitesands/dried,/area/template_noop)
"M" = (/obj/structure/tank_dispenser/oxygen,/turf/open/floor/plating/asteroid/whitesands/dried,/area/template_noop)
"N" = (/obj/structure/table,/turf/open/floor/plating/asteroid/whitesands/dried,/area/template_noop)
"P" = (/obj/item/stack/sheet/mineral/plasma/twenty,/obj/structure/table,/turf/open/floor/plating/asteroid/whitesands/dried,/area/template_noop)
"S" = (/obj/item/stack/sheet/mineral/titanium/fifty,/obj/structure/table,/turf/open/floor/plating/asteroid/whitesands/dried,/area/template_noop)
"U" = (/mob/living/simple_animal/hostile/whitesands/survivor,/turf/open/floor/plating/asteroid/whitesands/dried,/area/template_noop)
"V" = (/obj/structure/table,/obj/item/ammo_box/c45,/obj/item/ammo_box/c45,/turf/open/floor/plating/asteroid/whitesands/dried,/area/template_noop)
"W" = (/obj/structure/table,/obj/item/gun/ballistic/automatic/pistol/m1911,/turf/open/floor/plating/asteroid/whitesands/dried,/area/template_noop)
"Z" = (/obj/structure/table,/obj/item/gun/ballistic/rifle/boltaction/polymer,/turf/open/floor/plating/asteroid/whitesands/dried,/area/template_noop)

(1,1,1) = {"
aaaaaaaaaaaaaaaaaaaaaaaa
aaaaaaaaaaaaaaaaaaaaaaaa
aaaaaaaaaaaaaaaaaaaaaaaa
aaaaaaaaaaaaaaaaaaaaaaaa
aaaaaaaaaaaaaaaaaaaaaaaa
aaagggggggggggaaaaaaaaaa
aaagrrrrrrrrggaaaaaaaaaa
aaagriPvMSprgggggaaaaaaa
aaagrPgggggrgBBBgBBaaaaa
aaagrrrrrrurgBBBgggBaaaa
aaagryWVEEErgBBBgggggaaa
aaagrcgggUZrgBBBgggggaaa
aaggrNggnKKrggUggggggaaa
aaggrrsrrrrrrggggggggaaa
aaggrgggILggrggggggggaaa
aaggrIgLggggsggggggggaaa
aaggrrrrrrrrrggggggggaaa
aagggggggggggggggggggaaa
aaggggggBBBBBBBBBBBBaaaa
aaagggggBBBBBBBaaaaaaaaa
aaagggggggBBaaaaaaaaaaaa
aaaaaaaaaaaaaaaaaaaaaaaa
aaaaaaaaaaaaaaaaaaaaaaaa
aaaaaaaaaaaaaaaaaaaaaaaa
"}
