//MAP CONVERTED BY dmm2tgm.py THIS HEADER COMMENT PREVENTS RECONVERSION, DO NOT REMOVE
"bX" = (
/obj/effect/mob_spawn/human/corpse/damaged{
	head = /obj/item/clothing/head/kitty
	},
/turf/open/floor/wood,
/area/whitesands/surface/outdoors/unexplored)
"bY" = (
/turf/open/floor/wood{
	icon_state = "wood-broken6"
	},
/area/whitesands/surface/outdoors/unexplored)
"cn" = (
/obj/effect/spawner/lootdrop/donkpockets,
/obj/item/rack_parts,
/turf/open/floor/wood,
/area/whitesands/surface/outdoors/unexplored)
"cw" = (
/obj/effect/decal/cleanable/blood/gibs/limb,
/turf/open/floor/wood,
/area/whitesands/surface/outdoors/unexplored)
"cH" = (
/obj/structure/bed,
/obj/item/bedsheet/dorms,
/obj/structure/curtain,
/obj/machinery/iv_drip,
/obj/item/organ/ears/cat,
/turf/open/floor/wood,
/area/whitesands/surface/outdoors/unexplored)
"du" = (
/obj/item/reagent_containers/pill/trophazole,
/obj/effect/decal/cleanable/dirt,
/turf/open/floor/wood{
	icon_state = "wood-broken7"
	},
/area/whitesands/surface/outdoors/unexplored)
"dZ" = (
/turf/open/floor/wood{
	icon_state = "wood-broken5"
	},
/area/whitesands/surface/outdoors/unexplored)
"fG" = (
/obj/effect/decal/cleanable/blood/tracks{
	dir = 4
	},
/mob/living/simple_animal/hostile/cat_butcherer{
	desc = "Has gone mad after "the collaspe" and is now searching for a mythical race."
	},
/obj/effect/decal/cleanable/blood/gibs/limb,
/turf/open/floor/wood,
/area/whitesands/surface/outdoors/unexplored)
"fR" = (
/obj/structure/bed,
/obj/item/bedsheet/dorms,
/obj/structure/curtain,
/obj/machinery/iv_drip,
/obj/item/organ/tail/cat,
/obj/effect/decal/cleanable/blood/tracks{
	dir = 4
	},
/obj/effect/decal/cleanable/blood/tracks{
	dir = 4
	},
/turf/open/floor/wood,
/area/whitesands/surface/outdoors/unexplored)
"fS" = (
/obj/effect/decal/cleanable/blood/old,
/obj/effect/decal/cleanable/dirt,
/turf/open/floor/wood{
	icon_state = "wood-broken5"
	},
/area/whitesands/surface/outdoors/unexplored)
"gf" = (
/obj/structure/table/wood,
/turf/open/floor/wood{
	icon_state = "wood-broken7"
	},
/area/whitesands/surface/outdoors/unexplored)
"gZ" = (
/obj/structure/barricade/wooden,
/obj/structure/mineral_door/wood,
/obj/effect/decal/cleanable/blood,
/obj/effect/decal/cleanable/blood/tracks,
/turf/open/floor/wood,
/area/whitesands/surface/outdoors/unexplored)
"hK" = (
/obj/item/reagent_containers/pill/cyanide,
/turf/open/floor/wood,
/area/whitesands/surface/outdoors/unexplored)
"iv" = (
/obj/effect/decal/cleanable/blood/old,
/obj/effect/decal/cleanable/dirt,
/turf/open/floor/wood,
/area/whitesands/surface/outdoors/unexplored)
"iN" = (
/obj/structure/table/wood,
/obj/item/scalpel,
/obj/item/hemostat,
/obj/item/cautery,
/obj/effect/decal/cleanable/blood,
/obj/effect/decal/cleanable/blood/gibs,
/turf/open/floor/wood,
/area/whitesands/surface/outdoors/unexplored)
"iP" = (
/obj/structure/closet/secure_closet/chemical,
/obj/machinery/light,
/turf/open/floor/wood,
/area/whitesands/surface/outdoors/unexplored)
"jn" = (
/obj/structure/bed,
/obj/item/bedsheet/dorms,
/obj/structure/curtain,
/obj/machinery/iv_drip,
/obj/item/organ/ears/cat,
/obj/effect/mob_spawn/human/corpse/damaged{
	head = /obj/item/clothing/head/kitty
	},
/turf/open/floor/wood,
/area/whitesands/surface/outdoors/unexplored)
"jL" = (
/obj/effect/spawner/lootdrop/minor/kittyears_or_rabbitears,
/obj/effect/decal/cleanable/blood/old,
/turf/open/floor/wood,
/area/whitesands/surface/outdoors/unexplored)
"lr" = (
/turf/template_noop,
/area/template_noop)
"mD" = (
/turf/open/floor/plating,
/area/whitesands/surface/outdoors/unexplored)
"mK" = (
/obj/structure/bed,
/obj/item/bedsheet/dorms,
/obj/structure/curtain,
/obj/machinery/iv_drip,
/obj/item/organ/ears/cat,
/obj/item/organ/tail/cat,
/obj/effect/decal/cleanable/blood/gibs/torso,
/obj/effect/decal/cleanable/blood/tracks{
	dir = 4
	},
/obj/effect/mob_spawn/human/corpse/damaged{
	head = /obj/item/clothing/head/kitty
	},
/turf/open/floor/wood,
/area/whitesands/surface/outdoors/unexplored)
"np" = (
/obj/effect/spawner/structure/window,
/turf/open/floor/plating,
/area/whitesands/surface/outdoors/unexplored)
"pG" = (
/obj/structure/table/wood,
/obj/item/storage/toolbox/mechanical/old/clean,
/obj/effect/decal/cleanable/blood,
/obj/effect/decal/cleanable/blood/gibs/bubblegum,
/turf/open/floor/wood,
/area/whitesands/surface/outdoors/unexplored)
"qa" = (
/obj/machinery/door/window/northleft{
	dir = 4
	},
/obj/effect/decal/cleanable/dirt,
/turf/open/floor/wood,
/area/whitesands/surface/outdoors/unexplored)
"qn" = (
/obj/effect/decal/cleanable/blood/old,
/obj/effect/decal/cleanable/blood/tracks,
/turf/open/floor/wood,
/area/whitesands/surface/outdoors/unexplored)
"qr" = (
/obj/structure/girder,
/turf/open/floor/plating,
/area/whitesands/surface/outdoors/unexplored)
"rw" = (
/obj/structure/rack,
/obj/item/reagent_containers/pill/patch/synthflesh{
	pixel_x = -3;
	pixel_y = 3
	},
/turf/open/floor/wood,
/area/whitesands/surface/outdoors/unexplored)
"rX" = (
/obj/effect/decal/cleanable/dirt,
/turf/open/floor/wood{
	icon_state = "wood-broken5"
	},
/area/whitesands/surface/outdoors/unexplored)
"su" = (
/obj/structure/mineral_door/wood,
/obj/effect/decal/cleanable/blood/gibs/torso,
/obj/effect/decal/cleanable/blood/tracks{
	dir = 4
	},
/turf/open/floor/wood,
/area/whitesands/surface/outdoors/unexplored)
"tC" = (
/obj/effect/spawner/lootdrop/minor/kittyears_or_rabbitears,
/obj/effect/decal/cleanable/blood/old,
/obj/effect/decal/cleanable/dirt,
/turf/open/floor/wood,
/area/whitesands/surface/outdoors/unexplored)
"uc" = (
/obj/structure/barricade/wooden,
/obj/effect/decal/cleanable/blood/tracks{
	dir = 4
	},
/turf/open/floor/wood,
/area/whitesands/surface/outdoors/unexplored)
"un" = (
/obj/structure/table/wood,
/obj/item/chainsaw,
/obj/effect/decal/cleanable/blood,
/obj/effect/decal/cleanable/blood/gibs/bubblegum,
/obj/effect/decal/cleanable/blood/gibs/body,
/obj/item/toy/cattoy,
/obj/effect/decal/cleanable/blood/gibs/torso,
/turf/open/floor/wood,
/area/whitesands/surface/outdoors/unexplored)
"us" = (
/obj/effect/decal/cleanable/dirt,
/turf/open/floor/wood{
	icon_state = "wood-broken7"
	},
/area/whitesands/surface/outdoors/unexplored)
"uF" = (
/obj/item/reagent_containers/pill/patch/styptic{
	pixel_x = 3;
	pixel_y = -3
	},
/obj/item/reagent_containers/pill/patch/styptic,
/obj/item/reagent_containers/pill/patch/styptic{
	pixel_x = -3;
	pixel_y = 3
	},
/obj/item/rack_parts,
/turf/open/floor/wood,
/area/whitesands/surface/outdoors/unexplored)
"xX" = (
/obj/structure/closet/secure_closet/medical2,
/obj/effect/decal/cleanable/blood,
/obj/effect/decal/cleanable/blood/gibs/up,
/obj/effect/decal/cleanable/blood/gibs/torso,
/obj/item/organ/eyes/robotic/xray,
/turf/open/floor/wood,
/area/whitesands/surface/outdoors/unexplored)
"ym" = (
/obj/effect/decal/cleanable/blood,
/obj/item/melee/baton/cattleprod,
/turf/open/floor/wood,
/area/whitesands/surface/outdoors/unexplored)
"yF" = (
/obj/effect/decal/cleanable/blood,
/obj/effect/mob_spawn/human/corpse/damaged{
	head = /obj/item/clothing/head/kitty
	},
/obj/item/restraints/handcuffs,
/turf/open/floor/wood,
/area/whitesands/surface/outdoors/unexplored)
"zk" = (
/obj/structure/mineral_door/wood,
/turf/open/floor/wood,
/area/whitesands/surface/outdoors/unexplored)
"Ac" = (
/obj/structure/closet/secure_closet/medical1,
/turf/open/floor/wood,
/area/whitesands/surface/outdoors/unexplored)
"Ak" = (
/turf/closed/wall,
/area/whitesands/surface/outdoors/unexplored)
"AM" = (
/obj/structure/rack,
/obj/effect/spawner/lootdrop/minor/kittyears_or_rabbitears,
/obj/effect/decal/cleanable/dirt,
/turf/open/floor/wood,
/area/whitesands/surface/outdoors/unexplored)
"Bl" = (
/obj/structure/table/wood,
/obj/item/clothing/glasses/hud/health,
/turf/open/floor/wood,
/area/whitesands/surface/outdoors/unexplored)
"Bv" = (
/obj/structure/rack,
/obj/item/organ/ears/cat,
/obj/item/organ/tail/cat,
/obj/effect/spawner/lootdrop/minor/kittyears_or_rabbitears,
/obj/effect/decal/cleanable/dirt,
/turf/open/floor/wood,
/area/whitesands/surface/outdoors/unexplored)
"Dd" = (
/obj/structure/table/wood,
/turf/open/floor/wood,
/area/whitesands/surface/outdoors/unexplored)
"DU" = (
/obj/item/storage/pill_bottle/charcoal,
/obj/item/storage/pill_bottle/stimulant{
	pixel_x = -3;
	pixel_y = 3
	},
/obj/item/rack_parts,
/turf/open/floor/wood,
/area/whitesands/surface/outdoors/unexplored)
"EH" = (
/obj/structure/table/wood,
/obj/item/screwdriver/old,
/obj/item/organ/ears/cat,
/obj/item/organ/ears/cat{
	pixel_x = 5;
	pixel_y = -2
	},
/obj/effect/decal/cleanable/blood,
/obj/item/clothing/gloves/color/latex,
/obj/item/organ/tail/cat{
	pixel_x = -6;
	pixel_y = 3
	},
/obj/item/organ/tail/cat{
	pixel_x = 1;
	pixel_y = -5
	},
/obj/effect/decal/cleanable/blood/gibs/body,
/obj/effect/decal/cleanable/blood/gibs/torso,
/turf/open/floor/wood,
/area/whitesands/surface/outdoors/unexplored)
"Fc" = (
/obj/item/shard{
	icon_state = "tiny"
	},
/obj/item/shard{
	icon_state = "small"
	},
/turf/open/floor/plating,
/area/whitesands/surface/outdoors/unexplored)
"Fs" = (
/obj/effect/decal/cleanable/blood,
/turf/open/floor/wood,
/area/whitesands/surface/outdoors/unexplored)
"Fw" = (
/obj/effect/decal/cleanable/dirt,
/turf/open/floor/wood{
	icon_state = "wood-broken6"
	},
/area/whitesands/surface/outdoors/unexplored)
"Ik" = (
/obj/effect/spawner/lootdrop/minor/kittyears_or_rabbitears,
/obj/effect/decal/cleanable/blood/old,
/obj/item/gun/syringe,
/turf/open/floor/wood,
/area/whitesands/surface/outdoors/unexplored)
"JD" = (
/obj/structure/rack,
/obj/item/storage/pill_bottle/penacid{
	pixel_x = 3;
	pixel_y = -3
	},
/turf/open/floor/wood,
/area/whitesands/surface/outdoors/unexplored)
"KP" = (
/obj/structure/closet/secure_closet/medical3,
/obj/effect/decal/cleanable/dirt,
/turf/open/floor/wood,
/area/whitesands/surface/outdoors/unexplored)
"Mg" = (
/obj/structure/sign/departments/medbay,
/turf/closed/wall,
/area/whitesands/surface/outdoors/unexplored)
"MQ" = (
/obj/structure/table/wood,
/obj/effect/decal/cleanable/dirt,
/turf/open/floor/wood,
/area/whitesands/surface/outdoors/unexplored)
"MY" = (
/obj/structure/rack,
/turf/open/floor/wood,
/area/whitesands/surface/outdoors/unexplored)
"Ov" = (
/obj/machinery/chem_master,
/turf/open/floor/wood,
/area/whitesands/surface/outdoors/unexplored)
"PS" = (
/obj/structure/rack,
/obj/item/storage/firstaid/advanced{
	pixel_x = -3;
	pixel_y = 3
	},
/obj/item/storage/firstaid/brute,
/obj/item/storage/firstaid/fire{
	pixel_x = 3;
	pixel_y = -3
	},
/obj/effect/decal/cleanable/blood,
/turf/open/floor/wood,
/area/whitesands/surface/outdoors/unexplored)
"QI" = (
/obj/item/organ/ears/cat,
/obj/item/organ/tail/cat,
/obj/effect/decal/cleanable/blood/gibs/old,
/obj/effect/decal/cleanable/blood/tracks,
/mob/living/simple_animal/pet/cat/kitten{
	desc = "Has seen horrors beyond imagination. Seems to be unfazed.";
	name = "Lisa"
	},
/turf/open/floor/wood,
/area/whitesands/surface/outdoors/unexplored)
"RI" = (
/obj/item/shard{
	icon_state = "tiny"
	},
/obj/item/shard,
/turf/open/floor/plating,
/area/whitesands/surface/outdoors/unexplored)
"Tb" = (
/turf/closed/wall/rust,
/area/whitesands/surface/outdoors/unexplored)
"Ty" = (
/obj/structure/table/wood,
/obj/item/storage/firstaid/regular{
	empty = 1;
	name = "First-Aid (empty)"
	},
/turf/open/floor/wood,
/area/whitesands/surface/outdoors/unexplored)
"TH" = (
/obj/effect/decal/cleanable/dirt,
/turf/open/floor/wood,
/area/whitesands/surface/outdoors/unexplored)
"TV" = (
/obj/effect/decal/cleanable/blood/old,
/obj/effect/decal/cleanable/blood/old,
/obj/effect/decal/cleanable/dirt,
/turf/open/floor/wood,
/area/whitesands/surface/outdoors/unexplored)
"UB" = (
/obj/structure/rack,
/obj/effect/spawner/lootdrop/donkpockets,
/turf/open/floor/wood,
/area/whitesands/surface/outdoors/unexplored)
"UD" = (
/obj/structure/table/wood,
/obj/effect/decal/cleanable/blood/old,
/turf/open/floor/wood,
/area/whitesands/surface/outdoors/unexplored)
"Vt" = (
/obj/structure/table/optable,
/obj/effect/decal/cleanable/blood,
/obj/effect/mob_spawn/human/corpse/damaged{
	head = /obj/item/clothing/head/kitty
	},
/obj/item/restraints/handcuffs,
/turf/open/floor/wood,
/area/whitesands/surface/outdoors/unexplored)
"VC" = (
/obj/structure/girder/displaced,
/turf/open/floor/plating,
/area/whitesands/surface/outdoors/unexplored)
"VF" = (
/obj/item/shard{
	icon_state = "tiny"
	},
/obj/item/shard{
	icon_state = "medium"
	},
/turf/open/floor/plating,
/area/whitesands/surface/outdoors/unexplored)
"XP" = (
/obj/structure/closet/cabinet,
/obj/item/reagent_containers/glass/bottle/bromine,
/obj/item/reagent_containers/glass/bottle/aluminium,
/obj/item/reagent_containers/glass/bottle/chlorine,
/obj/item/reagent_containers/glass/bottle/carbon,
/obj/item/reagent_containers/glass/bottle/ethanol,
/obj/item/reagent_containers/glass/bottle/copper,
/obj/item/reagent_containers/glass/bottle/water,
/obj/item/reagent_containers/glass/bottle/hydrogen,
/obj/item/reagent_containers/glass/bottle/fluorine,
/obj/item/reagent_containers/glass/bottle/lithium,
/obj/item/reagent_containers/glass/bottle/iron,
/obj/item/reagent_containers/glass/bottle/iodine,
/obj/item/reagent_containers/glass/bottle/phosphorus,
/obj/item/reagent_containers/glass/bottle/nitrogen,
/obj/item/reagent_containers/glass/bottle/mercury,
/obj/item/reagent_containers/glass/bottle/oxygen,
/obj/item/reagent_containers/glass/bottle/nitrogen,
/obj/item/reagent_containers/glass/bottle/welding_fuel,
/obj/item/reagent_containers/glass/bottle/potassium,
/obj/item/reagent_containers/glass/bottle/radium,
/obj/item/reagent_containers/glass/bottle/sodium,
/obj/item/reagent_containers/glass/bottle/silver,
/obj/item/reagent_containers/glass/bottle/sulfur,
/obj/item/reagent_containers/glass/bottle/sugar,
/turf/open/floor/wood,
/area/whitesands/surface/outdoors/unexplored)
"XS" = (
/obj/structure/rack,
/obj/effect/spawner/lootdrop/minor/kittyears_or_rabbitears,
/turf/open/floor/wood{
	icon_state = "wood-broken5"
	},
/area/whitesands/surface/outdoors/unexplored)
"Ya" = (
/turf/open/floor/wood,
/area/whitesands/surface/outdoors/unexplored)
"Ym" = (
/obj/structure/rack,
/obj/item/storage/firstaid/o2{
	pixel_x = -3;
	pixel_y = 3
	},
/obj/item/storage/firstaid/toxin,
/obj/effect/decal/cleanable/blood/gibs/core,
/turf/open/floor/wood,
/area/whitesands/surface/outdoors/unexplored)
"Yv" = (
/obj/structure/table/wood,
/obj/item/paper_bin,
/obj/item/pen,
/turf/open/floor/wood,
/area/whitesands/surface/outdoors/unexplored)
"YA" = (
/obj/item/melee/baton/cattleprod,
/turf/open/floor/wood,
/area/whitesands/surface/outdoors/unexplored)
"YL" = (
/obj/effect/spawner/lootdrop/minor/kittyears_or_rabbitears,
/obj/item/rack_parts,
/obj/item/shard{
	icon_state = "small"
	},
/turf/open/floor/wood,
/area/whitesands/surface/outdoors/unexplored)

(1,1,1) = {"
VC
qr
mD
mD
qr
Tb
qr
mD
Ak
Tb
Tb
Ak
VC
"}
(2,1,1) = {"
np
AM
hK
gf
Ov
Bv
Ac
Ak
iN
Vt
pG
xX
Ak
"}
(3,1,1) = {"
VF
YL
du
Yv
TH
Fw
KP
Tb
un
Fs
EH
cw
Tb
"}
(4,1,1) = {"
qr
AM
dZ
Dd
dZ
Fw
iP
Tb
Fs
ym
Ya
bX
Tb
"}
(5,1,1) = {"
zk
Ya
Ya
Ty
iv
us
XP
Tb
bX
Ya
yF
PS
Ak
"}
(6,1,1) = {"
Mg
XS
bY
Bl
TH
rX
Ya
Ak
bX
fG
YA
Ym
Tb
"}
(7,1,1) = {"
qr
Ya
TH
Dd
MQ
UD
qa
Tb
Tb
su
Ak
Tb
Ak
"}
(8,1,1) = {"
Fc
JD
Ya
fS
tC
iv
jL
Ak
jn
uc
Ak
lr
lr
"}
(9,1,1) = {"
RI
DU
dZ
dZ
iv
Ik
TV
Tb
cH
mK
Tb
lr
lr
"}
(10,1,1) = {"
Tb
cn
UB
uF
MY
rw
qn
gZ
QI
fR
Ak
lr
lr
"}
(11,1,1) = {"
mD
Ak
mD
Tb
Ak
qr
mD
VC
Tb
Ak
Tb
lr
lr
"}
