//MAP CONVERTED BY dmm2tgm.py THIS HEADER COMMENT PREVENTS RECONVERSION, DO NOT REMOVE
"az" = (
/obj/machinery/atmospherics/pipe/manifold/cyan/visible,
/turf/open/floor/engine,
/area/space)
"aF" = (
/turf/open/floor/mineral/plastitanium/red,
/area/space)
"aO" = (
/obj/machinery/atmospherics/pipe/simple/cyan/visible,
/turf/open/floor/plating{
	icon_state = "platingdmg1"
	},
/area/space)
"cs" = (
/obj/effect/turf_decal/tile/yellow{
	dir = 4
	},
/obj/effect/turf_decal/tile/yellow{
	dir = 1
	},
/turf/open/floor/plasteel/dark,
/area/space)
"cO" = (
/obj/machinery/atmospherics/pipe/simple/scrubbers{
	dir = 5
	},
/turf/open/floor/plating{
	icon_state = "platingdmg1"
	},
/area/space)
"dw" = (
/obj/effect/turf_decal/stripes/corner{
	dir = 4
	},
/obj/machinery/atmospherics/pipe/simple/scrubbers{
	dir = 6
	},
/turf/open/floor/engine,
/area/space)
"dy" = (
/obj/machinery/atmospherics/pipe/simple/cyan/visible,
/obj/item/pipe_dispenser,
/turf/open/floor/plating{
	icon_state = "panelscorched"
	},
/area/space)
"dz" = (
/obj/machinery/atmospherics/pipe/simple/dark/visible{
	dir = 8
	},
/turf/open/floor/plating{
	icon_state = "platingdmg1"
	},
/area/space)
"fx" = (
/obj/item/circuitboard/machine/sleeper,
/turf/open/floor/plating{
	icon_state = "platingdmg1"
	},
/area/space)
"fz" = (
/obj/item/clothing/head/hardhat/red{
	desc = "A piece of headgear used in dangerous working conditions to protect the head. On closer inspection it apears to be a regular hardhat painted red.";
	name = "syndicate hardhat"
	},
/obj/machinery/atmospherics/components/unary/portables_connector/visible{
	dir = 8
	},
/turf/open/floor/plating{
	icon_state = "panelscorched"
	},
/area/space)
"gT" = (
/obj/structure/chair/comfy,
/turf/open/floor/plating{
	icon_state = "panelscorched"
	},
/area/space)
"he" = (
/obj/machinery/atmospherics/pipe/simple/cyan/visible{
	dir = 8
	},
/turf/open/floor/plating,
/area/space)
"hp" = (
/obj/machinery/atmospherics/pipe/manifold/scrubbers/visible,
/turf/open/floor/plating{
	icon_state = "platingdmg1"
	},
/area/space)
"hs" = (
/obj/machinery/atmospherics/pipe/manifold/scrubbers/visible{
	dir = 4
	},
/turf/open/floor/plating{
	icon_state = "platingdmg1"
	},
/area/space)
"hD" = (
/obj/machinery/portable_atmospherics/scrubber,
/turf/open/floor/plating/asteroid/whitesands,
/area/space)
"hS" = (
/obj/item/clothing/gloves/combat,
/turf/open/floor/plating/asteroid/whitesands,
/area/space)
"iz" = (
/obj/effect/decal/cleanable/ash,
/obj/item/paper{
	desc = null;
	info = "Well, we failed. The undoable has been done. We were taken out. The great Starfury is stuck in orbit, and many of our systems are damaged. There is no other choice but to evacuate. However, me and a group of talented indviduals will go with me. I will activate the hyperdrive, one last time to scuttle the ship before Nanotrasen can get their grubby little hands on it, on the planet of our greatest victory.  If you are worried about me, I have my tegu plushie and all i need to survive for a year. Men and women, its been a honour.";
	name = "Starfury Status Report - January 15th, 2501"
	},
/turf/open/floor/plating{
	icon_state = "panelscorched"
	},
/area/space)
"iR" = (
/obj/machinery/atmospherics/pipe/simple/dark/visible{
	dir = 10
	},
/turf/open/floor/plating{
	icon_state = "platingdmg1"
	},
/area/space)
"iU" = (
/obj/effect/turf_decal/stripes/white{
	dir = 1
	},
/obj/machinery/atmospherics/pipe/simple/dark/visible{
	dir = 5
	},
/turf/open/floor/engine,
/area/space)
"jb" = (
/obj/machinery/atmospherics/pipe/simple/scrubbers{
	dir = 8
	},
/turf/open/floor/plating/asteroid/whitesands,
/area/space)
"jQ" = (
/obj/machinery/atmospherics/components/unary/thermomachine/freezer{
	dir = 8
	},
/turf/open/floor/engine,
/area/space)
"kE" = (
/obj/machinery/atmospherics/pipe/simple/scrubbers,
/turf/open/floor/plating{
	icon_state = "panelscorched"
	},
/area/space)
"kV" = (
/obj/effect/turf_decal/bot,
/obj/machinery/portable_atmospherics/canister/toxins,
/obj/machinery/atmospherics/components/unary/portables_connector/visible{
	dir = 4
	},
/turf/open/floor/plasteel/dark,
/area/space)
"lt" = (
/obj/machinery/power/smes,
/turf/open/floor/plating{
	icon_state = "panelscorched"
	},
/area/space)
"lM" = (
/obj/item/storage/toolbox/syndicate,
/turf/open/floor/engine,
/area/space)
"nI" = (
/obj/machinery/suit_storage_unit,
/turf/open/floor/plating,
/area/space)
"nN" = (
/turf/open/floor/plasteel/dark,
/area/space)
"oa" = (
/turf/closed/wall/r_wall/syndicate,
/area/space)
"og" = (
/obj/structure/frame/machine,
/turf/open/floor/engine,
/area/space)
"oZ" = (
/obj/machinery/portable_atmospherics/scrubber,
/turf/open/floor/plating{
	icon_state = "platingdmg1"
	},
/area/space)
"pj" = (
/obj/machinery/atmospherics/pipe/manifold/cyan/visible{
	dir = 8
	},
/turf/open/floor/engine,
/area/space)
"pL" = (
/turf/open/floor/plating/asteroid/whitesands/dried,
/area/space)
"pN" = (
/obj/machinery/atmospherics/pipe/simple/scrubbers{
	dir = 8
	},
/turf/open/floor/plating{
	icon_state = "panelscorched"
	},
/area/space)
"qv" = (
/obj/effect/decal/cleanable/ash,
/obj/effect/decal/cleanable/ash{
	pixel_x = 3;
	pixel_y = -3
	},
/obj/effect/decal/cleanable/ash{
	pixel_x = 2;
	pixel_y = -2
	},
/turf/open/floor/plating{
	icon_state = "panelscorched"
	},
/area/space)
"qG" = (
/obj/machinery/power/generator,
/turf/open/floor/engine,
/area/space)
"se" = (
/obj/item/stock_parts/cell/empty,
/obj/item/stock_parts/cell/empty{
	pixel_x = -8;
	pixel_y = -7
	},
/obj/item/stock_parts/cell/empty{
	pixel_x = 6;
	pixel_y = -10
	},
/obj/item/storage/box/stockparts/deluxe,
/turf/open/floor/plating/asteroid/whitesands,
/area/space)
"sC" = (
/obj/machinery/atmospherics/pipe/simple/cyan/visible{
	dir = 9
	},
/turf/open/floor/plating{
	icon_state = "platingdmg1"
	},
/area/space)
"sS" = (
/obj/machinery/atmospherics/components/unary/portables_connector/visible,
/obj/machinery/portable_atmospherics/canister/toxins,
/turf/open/floor/plating,
/area/space)
"tw" = (
/obj/effect/turf_decal/radiation,
/turf/open/floor/plasteel/dark,
/area/space)
"ue" = (
/obj/machinery/atmospherics/components/unary/portables_connector/visible{
	dir = 4
	},
/obj/effect/turf_decal/bot,
/turf/open/floor/plasteel/dark,
/area/space)
"uP" = (
/obj/machinery/door/airlock/hatch,
/turf/open/floor/plasteel/dark,
/area/space)
"vr" = (
/obj/machinery/atmospherics/pipe/simple/scrubbers{
	dir = 10
	},
/turf/open/floor/plating{
	icon_state = "platingdmg1"
	},
/area/space)
"vJ" = (
/mob/living/simple_animal/hostile/syndicate/ranged/space/stormtrooper,
/turf/open/floor/plating{
	icon_state = "panelscorched"
	},
/area/space)
"vM" = (
/obj/item/pickaxe/improvised,
/turf/open/floor/plating/asteroid/whitesands,
/area/space)
"vW" = (
/obj/effect/turf_decal/stripes/white{
	dir = 1
	},
/turf/open/floor/engine,
/area/space)
"wg" = (
/obj/effect/turf_decal/bot,
/obj/machinery/portable_atmospherics/canister/toxins,
/obj/machinery/atmospherics/components/unary/portables_connector/visible{
	dir = 8
	},
/turf/open/floor/plasteel/dark,
/area/space)
"wL" = (
/turf/open/floor/plating{
	icon_state = "platingdmg1"
	},
/area/space)
"xK" = (
/obj/structure/frame/machine,
/obj/item/stack/cable_coil/cut/blue,
/turf/open/floor/mineral/plastitanium/red,
/area/space)
"yA" = (
/obj/effect/turf_decal/delivery,
/obj/machinery/portable_atmospherics/canister/toxins,
/turf/open/floor/plasteel/dark,
/area/space)
"yD" = (
/obj/effect/decal/cleanable/ash/large,
/turf/open/floor/plating{
	icon_state = "panelscorched"
	},
/area/space)
"yN" = (
/obj/item/stack/sheet/metal,
/turf/open/floor/plating{
	icon_state = "platingdmg1"
	},
/area/space)
"zh" = (
/obj/effect/turf_decal/stripes/white{
	dir = 8
	},
/turf/open/floor/engine,
/area/space)
"zk" = (
/obj/item/stack/sheet/metal,
/turf/open/floor/engine,
/area/space)
"zl" = (
/obj/item/stack/sheet/metal,
/obj/item/stack/sheet/metal,
/turf/open/floor/plating/asteroid/whitesands,
/area/space)
"zE" = (
/obj/machinery/atmospherics/pipe/manifold/scrubbers/visible{
	dir = 1
	},
/turf/open/floor/plating/asteroid/whitesands,
/area/space)
"AF" = (
/obj/machinery/door/airlock/engineering,
/turf/open/floor/plating,
/area/space)
"AQ" = (
/obj/structure/safe/floor,
/obj/item/clothing/suit/space/hardsuit/syndi,
/obj/item/melee/transforming/energy/sword/saber/red,
/obj/item/documents/syndicate,
/turf/open/floor/plating{
	icon_state = "panelscorched"
	},
/area/space)
"Ba" = (
/obj/machinery/atmospherics/pipe/simple/scrubbers,
/turf/open/floor/engine,
/area/space)
"Bk" = (
/turf/open/floor/pod/dark,
/area/space)
"Cf" = (
/obj/effect/turf_decal/stripes/white{
	dir = 1
	},
/obj/machinery/atmospherics/pipe/simple/dark/visible{
	dir = 8
	},
/turf/open/floor/engine,
/area/space)
"Cu" = (
/obj/machinery/atmospherics/pipe/simple/scrubbers{
	dir = 8
	},
/turf/open/floor/engine,
/area/space)
"Cz" = (
/obj/effect/turf_decal/stripes/white{
	dir = 4
	},
/turf/open/floor/engine,
/area/space)
"CF" = (
/obj/machinery/atmospherics/components/binary/pump,
/turf/open/floor/plating,
/area/space)
"Dn" = (
/obj/effect/turf_decal/tile/blue,
/turf/open/floor/plasteel/dark,
/area/space)
"DE" = (
/obj/machinery/atmospherics/pipe/manifold/scrubbers/visible{
	dir = 4
	},
/turf/open/floor/engine,
/area/space)
"Ec" = (
/obj/item/clothing/shoes/jackboots,
/turf/open/floor/plating/asteroid/whitesands,
/area/space)
"Ed" = (
/obj/structure/window/plasma/reinforced/plastitanium/unanchored,
/obj/machinery/atmospherics/pipe/simple/scrubbers,
/turf/open/floor/plating{
	icon_state = "platingdmg1"
	},
/area/space)
"Ey" = (
/obj/effect/decal/remains/human,
/obj/effect/decal/cleanable/blood/old,
/obj/item/clothing/under/syndicate{
	pixel_y = -11
	},
/turf/open/floor/plating/asteroid/whitesands,
/area/space)
"EM" = (
/turf/open/floor/plating,
/area/space)
"EX" = (
/obj/machinery/atmospherics/components/binary/pump{
	dir = 4
	},
/turf/open/floor/plating{
	icon_state = "panelscorched"
	},
/area/space)
"Fs" = (
/obj/structure/frame/machine,
/turf/open/floor/plating,
/area/space)
"Fw" = (
/obj/effect/turf_decal/tile/blue,
/obj/effect/turf_decal/tile/blue{
	dir = 8
	},
/turf/open/floor/plasteel/dark,
/area/space)
"FZ" = (
/obj/item/stack/tile/plasteel,
/turf/open/floor/plating/asteroid/whitesands/dried,
/area/space)
"Gj" = (
/obj/item/stack/sheet/metal,
/obj/item/stack/sheet/metal,
/obj/item/stack/sheet/metal,
/obj/machinery/atmospherics/pipe/simple/cyan/visible{
	dir = 8
	},
/turf/open/floor/plating{
	icon_state = "platingdmg1"
	},
/area/space)
"Gu" = (
/obj/machinery/atmospherics/pipe/manifold/dark/visible{
	dir = 4
	},
/turf/open/floor/engine,
/area/space)
"GP" = (
/obj/machinery/suit_storage_unit{
	mask_type = /obj/item/clothing/mask/gas/syndicate;
	storage_type = null
	},
/turf/open/floor/mineral/plastitanium/red,
/area/space)
"GV" = (
/obj/machinery/atmospherics/pipe/simple/dark/visible{
	dir = 5
	},
/turf/open/floor/plating/asteroid/whitesands{
	dir = 8
	},
/area/space)
"Hx" = (
/obj/machinery/atmospherics/pipe/simple/scrubbers{
	dir = 8
	},
/turf/open/floor/plating,
/area/space)
"Iw" = (
/obj/structure/frame/machine,
/obj/item/circuitboard/machine/smes,
/obj/item/stock_parts/capacitor,
/obj/item/stack/cable_coil/cut/blue,
/obj/item/stock_parts/cell/empty,
/turf/open/floor/plating{
	icon_state = "platingdmg2"
	},
/area/space)
"IC" = (
/obj/structure/frame/machine,
/turf/open/floor/plating{
	icon_state = "platingdmg1"
	},
/area/space)
"Jl" = (
/obj/machinery/atmospherics/components/binary/circulator{
	dir = 4
	},
/turf/open/floor/engine,
/area/space)
"JK" = (
/obj/machinery/atmospherics/pipe/simple/scrubbers{
	dir = 10
	},
/turf/open/floor/engine,
/area/space)
"JP" = (
/obj/item/stack/sheet/metal,
/obj/machinery/atmospherics/components/binary/pump{
	dir = 1
	},
/turf/open/floor/plating/asteroid/whitesands,
/area/space)
"JQ" = (
/turf/open/floor/plating/asteroid/whitesands,
/area/space)
"Kv" = (
/obj/item/toy/plush/lizardplushie,
/turf/open/floor/plating/asteroid/whitesands,
/area/space)
"Kw" = (
/obj/item/gun/ballistic/automatic/pistol,
/turf/open/floor/plating/asteroid/whitesands,
/area/space)
"KB" = (
/obj/item/clothing/neck/stethoscope,
/turf/open/floor/plating,
/area/space)
"KN" = (
/obj/item/storage/firstaid/ancient,
/turf/open/floor/plating/asteroid/whitesands,
/area/space)
"LE" = (
/obj/machinery/atmospherics/pipe/simple/cyan/visible,
/turf/open/floor/plating,
/area/space)
"LJ" = (
/obj/machinery/atmospherics/pipe/simple/dark/visible,
/turf/closed/wall/r_wall/syndicate,
/area/space)
"LS" = (
/obj/structure/frame/machine,
/obj/item/circuitboard/machine/sleeper,
/turf/open/floor/plating{
	icon_state = "panelscorched"
	},
/area/space)
"LY" = (
/obj/structure/window/plasma/reinforced/plastitanium/unanchored,
/turf/open/floor/plating{
	icon_state = "platingdmg1"
	},
/area/space)
"Ma" = (
/obj/machinery/atmospherics/pipe/simple/cyan/visible{
	dir = 6
	},
/turf/open/floor/engine,
/area/space)
"Mc" = (
/mob/living/simple_animal/hostile/syndicate/ranged/shotgun,
/turf/open/floor/plating/asteroid/whitesands,
/area/space)
"Md" = (
/turf/open/floor/plating{
	icon_state = "platingdmg2"
	},
/area/space)
"Mm" = (
/obj/effect/turf_decal/loading_area/red,
/turf/open/floor/plasteel/dark,
/area/space)
"MD" = (
/obj/machinery/portable_atmospherics/canister/toxins,
/turf/open/floor/plating{
	icon_state = "panelscorched"
	},
/area/space)
"Ne" = (
/obj/machinery/atmospherics/pipe/manifold/cyan/visible{
	dir = 8
	},
/turf/open/floor/plating,
/area/space)
"NC" = (
/obj/machinery/atmospherics/components/binary/pump{
	dir = 1
	},
/turf/open/floor/plating{
	icon_state = "platingdmg1"
	},
/area/space)
"NM" = (
/obj/item/stock_parts/cell/empty{
	pixel_x = 5;
	pixel_y = -6
	},
/obj/machinery/power/terminal{
	dir = 1
	},
/turf/open/floor/plating/asteroid/whitesands/dried,
/area/space)
"Oe" = (
/obj/machinery/atmospherics/components/binary/circulator/cold{
	dir = 8
	},
/turf/open/floor/engine,
/area/space)
"OB" = (
/obj/effect/turf_decal/stripes/white{
	dir = 1
	},
/obj/machinery/atmospherics/pipe/simple/cyan/visible{
	dir = 5
	},
/turf/open/floor/engine,
/area/space)
"OI" = (
/mob/living/simple_animal/hostile/syndicate/ranged,
/turf/open/floor/plating,
/area/space)
"ON" = (
/obj/machinery/power/terminal{
	dir = 1
	},
/turf/open/floor/plating{
	icon_state = "platingdmg1"
	},
/area/space)
"Pi" = (
/obj/machinery/power/smes,
/turf/open/floor/plating{
	icon_state = "platingdmg2"
	},
/area/space)
"QK" = (
/mob/living/simple_animal/hostile/syndicate/ranged/smg/space,
/turf/open/floor/plating{
	icon_state = "platingdmg2"
	},
/area/space)
"QS" = (
/obj/effect/turf_decal/tile/yellow{
	dir = 4
	},
/turf/open/floor/plasteel/dark,
/area/space)
"RE" = (
/obj/effect/turf_decal/stripes/white{
	dir = 1
	},
/obj/machinery/atmospherics/pipe/simple/scrubbers,
/turf/open/floor/engine,
/area/space)
"RJ" = (
/turf/closed/mineral/random/whitesands,
/area/space)
"RK" = (
/obj/structure/door_assembly/door_assembly_hatch,
/turf/open/floor/plating,
/area/space)
"RT" = (
/turf/open/floor/plating{
	icon_state = "panelscorched"
	},
/area/space)
"ST" = (
/obj/machinery/atmospherics/components/unary/portables_connector/visible,
/obj/machinery/portable_atmospherics/canister/oxygen,
/turf/open/floor/plating{
	icon_state = "platingdmg1"
	},
/area/space)
"Tx" = (
/obj/machinery/atmospherics/pipe/simple/scrubbers,
/turf/open/floor/plating{
	icon_state = "platingdmg1"
	},
/area/space)
"Uc" = (
/obj/effect/turf_decal/tile/blue{
	dir = 8
	},
/turf/open/floor/plasteel/dark,
/area/space)
"Uv" = (
/obj/item/stack/cable_coil/cut/blue,
/obj/item/stack/tile/plasteel,
/turf/open/floor/plating/asteroid/whitesands/dried,
/area/space)
"Va" = (
/obj/machinery/atmospherics/pipe/simple/cyan/visible{
	dir = 10
	},
/turf/open/floor/plating,
/area/space)
"Vc" = (
/obj/effect/turf_decal/stripes/white{
	dir = 1
	},
/obj/machinery/atmospherics/pipe/simple/cyan/visible{
	dir = 8
	},
/turf/open/floor/engine,
/area/space)
"VC" = (
/obj/machinery/atmospherics/pipe/simple/cyan/visible{
	dir = 8
	},
/turf/open/floor/plating{
	icon_state = "platingdmg1"
	},
/area/space)
"Wc" = (
/obj/effect/turf_decal/stripes/white{
	dir = 5
	},
/turf/open/floor/engine,
/area/space)
"We" = (
/obj/machinery/atmospherics/components/binary/pump,
/turf/open/floor/engine,
/area/space)
"XV" = (
/turf/open/floor/engine,
/area/space)
"XX" = (
/obj/machinery/atmospherics/pipe/simple/cyan/visible,
/turf/open/floor/engine,
/area/space)
"Yx" = (
/obj/effect/turf_decal/stripes/white{
	dir = 1
	},
/obj/machinery/atmospherics/components/binary/pump,
/obj/machinery/atmospherics/pipe/simple/dark/visible{
	dir = 8
	},
/turf/open/floor/engine,
/area/space)
"ZP" = (
/obj/item/stack/sheet/metal,
/turf/open/floor/plating/asteroid/whitesands,
/area/space)

(1,1,1) = {"
RJ
RJ
RJ
RJ
RJ
RJ
RJ
RJ
RJ
RJ
RJ
RJ
RJ
RJ
RJ
RJ
lt
NM
RJ
RJ
RJ
JQ
RJ
RJ
RJ
RJ
RJ
RJ
RJ
RJ
"}
(2,1,1) = {"
RJ
RJ
RJ
RJ
RJ
RJ
RJ
RJ
RJ
RJ
RJ
RJ
RJ
RJ
RJ
oa
Iw
se
FZ
hD
RJ
JQ
oa
oa
oa
oa
RJ
RJ
RJ
RJ
"}
(3,1,1) = {"
RJ
RJ
RJ
RJ
RJ
RJ
RJ
RJ
RJ
RJ
JQ
wL
oa
RJ
RJ
oa
Pi
ON
Uv
RJ
oa
LY
oa
JQ
JQ
JQ
RJ
RJ
RJ
RJ
"}
(4,1,1) = {"
RJ
RJ
RJ
RJ
RJ
RJ
RJ
RJ
RJ
JQ
EM
JQ
oa
oa
oa
oa
oa
oa
AF
oa
oa
wL
JQ
RT
JQ
JQ
RJ
RJ
RJ
RJ
"}
(5,1,1) = {"
RJ
RJ
RJ
RJ
RJ
RJ
RJ
RJ
RJ
RT
RT
wL
nN
tw
Mm
AF
RT
JQ
RT
JQ
RT
zh
zh
sS
GV
Md
RJ
RJ
RJ
RJ
"}
(6,1,1) = {"
RJ
RJ
RJ
RJ
RJ
RJ
RJ
RJ
RJ
RJ
Md
JQ
RT
tw
Mm
AF
vW
zk
Mc
wL
XV
RT
wL
ST
Gu
iU
RJ
RJ
RJ
RJ
"}
(7,1,1) = {"
RJ
RJ
RJ
RJ
RJ
RJ
oa
RJ
oa
oa
nN
JQ
oa
oa
oa
oa
Wc
dw
Ba
yN
Ba
Ba
Ba
Tx
cO
Cf
RJ
RJ
RJ
RJ
"}
(8,1,1) = {"
RJ
RJ
RJ
RJ
RJ
RJ
RJ
KN
fx
oa
JQ
EM
oa
RT
yD
oa
oa
jb
wL
zl
RT
MD
wL
XV
Cu
dz
oa
RJ
RJ
RJ
"}
(9,1,1) = {"
RJ
RJ
RJ
RJ
RJ
oa
oa
Md
JQ
oa
QS
Dn
oa
gT
iz
oa
oa
pN
oZ
RT
wL
kV
ue
wL
zE
Yx
RJ
RJ
RJ
RJ
"}
(10,1,1) = {"
RJ
RJ
RJ
RJ
RJ
RJ
RJ
JQ
Md
RK
cs
Fw
uP
vJ
qv
oa
oa
Hx
EM
EM
JQ
vr
hp
XV
EX
iR
LJ
RJ
RJ
RJ
"}
(11,1,1) = {"
RJ
RJ
RJ
RJ
RJ
RJ
RJ
KB
EM
oa
Md
Uc
oa
RT
RT
oa
oa
JK
Ba
JP
Jl
NC
DE
kE
hs
RE
Ed
RJ
RJ
RJ
"}
(12,1,1) = {"
RJ
RJ
RJ
RJ
RJ
RJ
RJ
RJ
Fs
oa
nN
nN
oa
AQ
LS
oa
oa
RT
XV
XV
qG
XV
EM
XV
XV
Md
LY
RJ
RJ
RJ
"}
(13,1,1) = {"
RJ
RJ
RJ
RJ
RJ
RJ
RJ
oa
oa
oa
uP
uP
oa
oa
oa
oa
oa
Ma
aO
We
Oe
CF
Ne
dy
LE
OB
LY
RJ
RJ
RJ
"}
(14,1,1) = {"
RJ
RJ
RJ
RJ
RJ
RJ
RJ
RJ
RJ
RJ
RT
wL
GP
nI
xK
oa
oa
he
EM
OI
XV
Ma
az
XV
RT
VC
oa
RJ
RJ
RJ
"}
(15,1,1) = {"
RJ
RJ
RJ
RJ
RJ
RJ
RJ
RJ
RJ
RJ
JQ
JQ
wL
QK
Bk
oa
oa
Gj
ZP
JQ
lM
wg
fz
XV
wL
Vc
RJ
RJ
RJ
RJ
"}
(16,1,1) = {"
RJ
RJ
RJ
RJ
RJ
RJ
RJ
RJ
RJ
RJ
JQ
JQ
aF
Md
EM
oa
oa
he
ZP
wL
XV
wL
yA
RT
wL
VC
oa
RJ
RJ
RJ
"}
(17,1,1) = {"
RJ
RJ
RJ
RJ
RJ
RJ
RJ
RJ
RJ
RJ
JQ
JQ
JQ
JQ
JQ
oa
RJ
Va
LE
LE
XX
pj
pj
pj
Ne
sC
JQ
RJ
RJ
RJ
"}
(18,1,1) = {"
RJ
RJ
RJ
RJ
RJ
RJ
RJ
RJ
RJ
JQ
Kw
JQ
JQ
JQ
JQ
RJ
RJ
RJ
RJ
RJ
RJ
jQ
og
IC
jQ
vW
JQ
RJ
RJ
RJ
"}
(19,1,1) = {"
RJ
RJ
RJ
RJ
RJ
RJ
RJ
RJ
JQ
JQ
Ey
Ec
JQ
JQ
RJ
RJ
RJ
RJ
RJ
RJ
RJ
Cz
Cz
Cz
Cz
pL
RJ
RJ
RJ
RJ
"}
(20,1,1) = {"
RJ
RJ
RJ
RJ
RJ
RJ
RJ
JQ
JQ
vM
hS
JQ
JQ
RJ
RJ
RJ
RJ
RJ
RJ
RJ
RJ
nN
wL
pL
pL
RJ
RJ
RJ
RJ
RJ
"}
(21,1,1) = {"
RJ
RJ
RJ
RJ
RJ
RJ
RJ
Kv
JQ
JQ
RJ
RJ
RJ
RJ
RJ
RJ
RJ
RJ
RJ
RJ
RJ
oa
oa
nN
nN
nN
RJ
RJ
RJ
RJ
"}
(22,1,1) = {"
RJ
RJ
RJ
RJ
RJ
RJ
RJ
RJ
RJ
RJ
RJ
RJ
RJ
RJ
RJ
RJ
RJ
RJ
RJ
RJ
RJ
RJ
oa
LY
oa
RJ
RJ
RJ
RJ
RJ
"}
(23,1,1) = {"
RJ
RJ
RJ
RJ
RJ
RJ
RJ
RJ
RJ
RJ
RJ
RJ
RJ
RJ
RJ
RJ
RJ
RJ
RJ
RJ
RJ
RJ
RJ
RJ
RJ
RJ
RJ
RJ
RJ
RJ
"}
(24,1,1) = {"
RJ
RJ
RJ
RJ
RJ
RJ
RJ
RJ
RJ
RJ
RJ
RJ
RJ
RJ
RJ
RJ
RJ
RJ
RJ
RJ
RJ
RJ
RJ
RJ
RJ
RJ
RJ
RJ
RJ
RJ
"}
(25,1,1) = {"
RJ
RJ
RJ
RJ
RJ
RJ
RJ
RJ
RJ
RJ
RJ
RJ
RJ
RJ
RJ
RJ
RJ
RJ
RJ
RJ
RJ
RJ
RJ
RJ
RJ
RJ
RJ
RJ
RJ
RJ
"}
(26,1,1) = {"
RJ
RJ
RJ
RJ
RJ
RJ
RJ
RJ
RJ
RJ
RJ
RJ
RJ
RJ
RJ
RJ
RJ
RJ
RJ
RJ
RJ
RJ
RJ
RJ
RJ
RJ
RJ
RJ
RJ
RJ
"}
(27,1,1) = {"
RJ
RJ
RJ
RJ
RJ
RJ
RJ
RJ
RJ
RJ
RJ
RJ
RJ
RJ
RJ
RJ
RJ
RJ
RJ
RJ
RJ
RJ
RJ
RJ
RJ
RJ
RJ
RJ
RJ
RJ
"}
(28,1,1) = {"
RJ
RJ
RJ
RJ
RJ
RJ
RJ
RJ
RJ
RJ
RJ
RJ
RJ
RJ
RJ
RJ
RJ
RJ
RJ
RJ
RJ
RJ
RJ
RJ
RJ
RJ
RJ
RJ
RJ
RJ
"}
(29,1,1) = {"
RJ
RJ
RJ
RJ
RJ
RJ
RJ
RJ
RJ
RJ
RJ
RJ
RJ
RJ
RJ
RJ
RJ
RJ
RJ
RJ
RJ
RJ
RJ
RJ
RJ
RJ
RJ
RJ
RJ
RJ
"}
(30,1,1) = {"
RJ
RJ
RJ
RJ
RJ
RJ
RJ
RJ
RJ
RJ
RJ
RJ
RJ
RJ
RJ
RJ
RJ
RJ
RJ
RJ
RJ
RJ
RJ
RJ
RJ
RJ
RJ
RJ
RJ
RJ
"}
