"a" = (/turf/template_noop,/area/template_noop)
"b" = (/turf/open/floor/plating{icon_state = "panelscorched"; initial_gas_mix = "ws_atmos"},/area/whitesands/surface/outdoors/unexplored)
"c" = (/obj/effect/spawner/structure/window/plasma/reinforced,/turf/open/floor/plating{initial_gas_mix = "ws_atmos"},/area/whitesands/surface/outdoors/unexplored)
"f" = (/turf/open/floor/plating/asteroid/whitesands,/area/whitesands/surface/outdoors/unexplored)
"g" = (/obj/effect/turf_decal/bot{dir = 1},/turf/open/floor/plasteel/dark,/area/whitesands/surface/outdoors/unexplored)
"i" = (/obj/effect/decal/cleanable/greenglow,/obj/item/disk/plantgene,/turf/open/floor/plating{icon_state = "platingdmg2"; initial_gas_mix = "ws_atmos"},/area/whitesands/surface/outdoors/unexplored)
"j" = (/obj/machinery/atmospherics/pipe/simple/general/visible{dir = 10},/turf/closed/wall/r_wall,/area/whitesands/surface/outdoors/unexplored)
"k" = (/obj/structure/window/plasma/reinforced,/obj/machinery/power/rad_collector/anchored,/obj/machinery/atmospherics/pipe/simple/general/visible{dir = 10},/turf/open/floor/plating/asteroid/whitesands,/area/whitesands/surface/outdoors/unexplored)
"n" = (/obj/effect/decal/cleanable/dirt,/turf/open/floor/plating{icon_state = "panelscorched"; initial_gas_mix = "ws_atmos"},/area/whitesands/surface/outdoors/unexplored)
"r" = (/obj/machinery/atmospherics/components/unary/vent_scrubber/on,/obj/effect/decal/cleanable/dirt,/turf/open/floor/engine,/area/whitesands/surface/outdoors/unexplored)
"s" = (/obj/effect/turf_decal/bot{dir = 1},/obj/machinery/portable_atmospherics/canister/nitrogen,/turf/open/floor/plasteel/dark,/area/whitesands/surface/outdoors/unexplored)
"t" = (/obj/machinery/atmospherics/components/unary/vent_scrubber/on,/turf/open/floor/engine,/area/whitesands/surface/outdoors/unexplored)
"u" = (/obj/machinery/atmospherics/pipe/simple/general/visible{dir = 9},/turf/closed/wall/r_wall,/area/whitesands/surface/outdoors/unexplored)
"w" = (/turf/closed/wall/r_wall,/area/whitesands/surface/outdoors/unexplored)
"x" = (/obj/effect/mob_spawn/human/engineer{gender = "female"; mob_species = /datum/species/mothmen},/obj/item/clothing/suit/radiation,/obj/item/clothing/head/radiation{pixel_x = -1; pixel_y = 9},/obj/item/geiger_counter,/turf/open/floor/engine,/area/whitesands/surface/outdoors/unexplored)
"z" = (/obj/effect/decal/cleanable/dirt,/turf/open/floor/plating{initial_gas_mix = "ws_atmos"},/area/whitesands/surface/outdoors/unexplored)
"B" = (/obj/effect/turf_decal/delivery,/obj/effect/decal/cleanable/dirt,/turf/open/floor/plasteel/dark,/area/whitesands/surface/outdoors/unexplored)
"C" = (/obj/effect/decal/cleanable/dirt,/turf/open/floor/engine,/area/whitesands/surface/outdoors/unexplored)
"E" = (/obj/effect/decal/cleanable/greenglow,/obj/effect/decal/cleanable/dirt,/turf/open/floor/plating{initial_gas_mix = "ws_atmos"},/area/whitesands/surface/outdoors/unexplored)
"G" = (/obj/machinery/atmospherics/components/binary/pump{dir = 8},/turf/open/floor/plating{icon_state = "platingdmg2"; initial_gas_mix = "ws_atmos"},/area/whitesands/surface/outdoors/unexplored)
"H" = (/obj/structure/girder/displaced,/turf/open/floor/plating{initial_gas_mix = "ws_atmos"},/area/whitesands/surface/outdoors/unexplored)
"I" = (/obj/machinery/atmospherics/components/unary/vent_pump/on{dir = 1},/obj/effect/decal/cleanable/dirt,/turf/open/floor/engine,/area/whitesands/surface/outdoors/unexplored)
"J" = (/obj/structure/window/plasma/reinforced{dir = 1},/obj/structure/frame/machine,/obj/machinery/atmospherics/pipe/simple/general/visible{dir = 9},/obj/machinery/atmospherics/pipe/simple/general/visible{dir = 9},/turf/open/floor/plating{icon_state = "platingdmg2"; initial_gas_mix = "ws_atmos"},/area/whitesands/surface/outdoors/unexplored)
"L" = (/obj/structure/window/plasma/reinforced{dir = 1},/obj/machinery/power/rad_collector/anchored,/obj/machinery/atmospherics/pipe/manifold/general/visible,/turf/open/floor/plating{icon_state = "platingdmg1"; initial_gas_mix = "ws_atmos"},/area/whitesands/surface/outdoors/unexplored)
"Q" = (/obj/machinery/atmospherics/pipe/simple/general/visible{dir = 6},/obj/structure/girder,/turf/open/floor/plating{initial_gas_mix = "ws_atmos"},/area/whitesands/surface/outdoors/unexplored)
"R" = (/obj/structure/window/plasma/reinforced,/obj/machinery/power/rad_collector/anchored,/obj/machinery/atmospherics/pipe/manifold/general/visible{dir = 1},/turf/open/floor/plating{icon_state = "platingdmg2"; initial_gas_mix = "ws_atmos"},/area/whitesands/surface/outdoors/unexplored)
"S" = (/turf/open/floor/plating{initial_gas_mix = "ws_atmos"},/area/whitesands/surface/outdoors/unexplored)
"T" = (/obj/structure/window/plasma/reinforced{dir = 1},/obj/structure/frame/machine,/obj/machinery/atmospherics/pipe/manifold/general/visible,/turf/open/floor/engine,/area/whitesands/surface/outdoors/unexplored)
"V" = (/turf/open/floor/plating{icon_state = "platingdmg1"; initial_gas_mix = "ws_atmos"},/area/whitesands/surface/outdoors/unexplored)
"W" = (/obj/machinery/door/airlock/engineering/glass/critical{heat_proof = 1; name = "Supermatter Chamber"; req_access_txt = "10"},/turf/open/floor/plating{icon_state = "platingdmg2"; initial_gas_mix = "ws_atmos"},/area/whitesands/surface/outdoors/unexplored)
"X" = (/obj/structure/girder,/turf/open/floor/plating{initial_gas_mix = "ws_atmos"},/area/whitesands/surface/outdoors/unexplored)
"Y" = (/obj/machinery/door/airlock/engineering/glass/critical{heat_proof = 1; name = "Supermatter Chamber"; req_access_txt = "10"},/turf/open/floor/engine,/area/whitesands/surface/outdoors/unexplored)
"Z" = (/obj/structure/window/plasma/reinforced,/obj/structure/frame/machine,/obj/machinery/atmospherics/pipe/manifold/general/visible{dir = 1},/turf/open/floor/plating{icon_state = "platingdmg1"; initial_gas_mix = "ws_atmos"},/area/whitesands/surface/outdoors/unexplored)

(1,1,1) = {"
aswaaSX
zzXVzSw
XwQRZkw
wzuIIIw
WxYiECc
wGjrrtw
HwwLTJw
BgwfnCX
aawabaw
"}
