//MAP CONVERTED BY dmm2tgm.py THIS HEADER COMMENT PREVENTS RECONVERSION, DO NOT REMOVE
"ak" = (
/turf/closed/wall/mineral/titanium,
/area/ruin/space/has_grav/drunk_driving)
"ax" = (
/obj/structure/table,
/obj/machinery/microwave,
/turf/open/floor/plasteel/airless,
/area/ruin/space/has_grav/drunk_driving)
"aS" = (
/obj/machinery/power/shuttle/engine/fueled/plasma{
	dir = 4
	},
/turf/open/floor/plating,
/area/ruin/space/has_grav/drunk_driving)
"bb" = (
/obj/machinery/atmospherics/pipe/manifold/general/hidden{
	dir = 1
	},
/obj/effect/decal/cleanable/dirt/dust,
/obj/effect/decal/cleanable/dirt/dust,
/turf/open/floor/plasteel/airless,
/area/ruin/space/has_grav/drunk_driving)
"bg" = (
/obj/machinery/light/broken,
/obj/item/storage/belt,
/obj/effect/decal/cleanable/vomit/old,
/turf/open/floor/plasteel/airless,
/area/ruin/space/has_grav/drunk_driving)
"bA" = (
/obj/structure/table,
/obj/effect/decal/cleanable/oil/slippery,
/turf/open/floor/plasteel/airless,
/area/ruin/space/has_grav/drunk_driving)
"ef" = (
/obj/machinery/atmospherics/components/binary/pump{
	dir = 8
	},
/obj/effect/decal/cleanable/dirt/dust,
/obj/effect/decal/cleanable/plasma,
/turf/open/floor/plasteel/airless,
/area/ruin/space/has_grav/drunk_driving)
"ei" = (
/obj/structure/frame/computer{
	anchored = 1;
	dir = 1
	},
/turf/closed/mineral/random,
/area/ruin/space/has_grav/drunk_driving)
"et" = (
/obj/structure/grille,
/turf/open/floor/plating,
/area/ruin/space/has_grav/drunk_driving)
"fi" = (
/obj/structure/tank_dispenser/oxygen,
/obj/effect/decal/cleanable/dirt/dust,
/turf/open/floor/plasteel,
/area/ruin/space/has_grav/drunk_driving)
"hx" = (
/obj/machinery/door/airlock/external,
/obj/machinery/atmospherics/pipe/simple/general/hidden{
	dir = 8
	},
/turf/open/floor/plating,
/area/ruin/space/has_grav/drunk_driving)
"hB" = (
/obj/structure/chair{
	dir = 4
	},
/obj/item/stack/sheet/mineral/titanium,
/obj/item/wrench,
/obj/effect/decal/cleanable/glass,
/turf/open/floor/plasteel/airless,
/area/ruin/space/has_grav/drunk_driving)
"hN" = (
/turf/open/space/basic,
/area/space)
"kc" = (
/obj/structure/closet/secure_closet/freezer/kitchen/maintenance,
/turf/open/floor/plasteel/airless,
/area/ruin/space/has_grav/drunk_driving)
"kn" = (
/obj/structure/frame/computer{
	anchored = 1;
	dir = 8
	},
/obj/item/shard,
/obj/effect/decal/cleanable/glass,
/turf/open/floor/plasteel/airless,
/area/ruin/space/has_grav/drunk_driving)
"kr" = (
/obj/item/pickaxe/drill,
/obj/structure/rack,
/obj/item/mining_scanner,
/obj/item/storage/bag/ore,
/turf/open/floor/plasteel,
/area/ruin/space/has_grav/drunk_driving)
"lL" = (
/obj/machinery/atmospherics/components/unary/vent_pump,
/obj/effect/decal/cleanable/generic,
/turf/open/floor/plasteel/airless,
/area/ruin/space/has_grav/drunk_driving)
"ma" = (
/obj/machinery/atmospherics/pipe/simple/general/hidden,
/obj/structure/cable{
	icon_state = "0-4"
	},
/obj/machinery/power/apc/auto_name/west{
	pixel_x = -24
	},
/obj/effect/turf_decal/stripes/red{
	dir = 1
	},
/turf/open/floor/plasteel/airless,
/area/ruin/space/has_grav/drunk_driving)
"mk" = (
/obj/machinery/atmospherics/pipe/simple/general/hidden{
	dir = 8
	},
/obj/effect/decal/cleanable/dirt/dust,
/turf/open/floor/plasteel,
/area/ruin/space/has_grav/drunk_driving)
"mX" = (
/obj/effect/decal/cleanable/plasma,
/turf/open/floor/plasteel/airless{
	icon_state = "floorscorched2"
	},
/area/ruin/space/has_grav/drunk_driving)
"ov" = (
/obj/machinery/atmospherics/pipe/simple/general/hidden,
/obj/effect/decal/cleanable/dirt/dust,
/turf/open/floor/plasteel/airless,
/area/ruin/space/has_grav/drunk_driving)
"oF" = (
/obj/machinery/atmospherics/pipe/simple/general/hidden{
	dir = 8
	},
/obj/effect/decal/cleanable/dirt/dust,
/obj/item/screwdriver,
/obj/effect/decal/cleanable/plasma,
/turf/open/floor/plasteel/airless,
/area/ruin/space/has_grav/drunk_driving)
"pL" = (
/obj/machinery/light/broken{
	dir = 4
	},
/obj/item/stack/sheet/mineral/gold/five,
/turf/open/floor/plasteel,
/area/ruin/space/has_grav/drunk_driving)
"pO" = (
/obj/machinery/atmospherics/components/unary/vent_pump,
/obj/effect/decal/cleanable/dirt/dust,
/obj/item/crowbar,
/turf/open/floor/plasteel,
/area/ruin/space/has_grav/drunk_driving)
"rC" = (
/obj/item/stack/sheet/mineral/titanium,
/obj/effect/decal/cleanable/generic,
/obj/effect/decal/cleanable/glass,
/obj/effect/decal/cleanable/plasma,
/turf/open/floor/plasteel/airless{
	icon_state = "floorscorched2"
	},
/area/ruin/space/has_grav/drunk_driving)
"sD" = (
/obj/effect/spawner/structure/window/shuttle,
/turf/closed/mineral/random,
/area/ruin/space/has_grav/drunk_driving)
"tK" = (
/obj/machinery/atmospherics/pipe/manifold4w/general/hidden,
/obj/effect/turf_decal/stripes/red{
	dir = 8
	},
/turf/open/floor/plasteel/airless{
	icon_state = "floorscorched2"
	},
/area/ruin/space/has_grav/drunk_driving)
"uc" = (
/obj/structure/table,
/obj/item/weldingtool/largetank,
/turf/open/floor/plasteel/airless,
/area/ruin/space/has_grav/drunk_driving)
"uo" = (
/turf/open/floor/plasteel/airless{
	icon_state = "floorscorched2"
	},
/area/ruin/space/has_grav/drunk_driving)
"up" = (
/obj/machinery/atmospherics/components/binary/pump{
	dir = 8
	},
/obj/effect/decal/cleanable/dirt/dust,
/turf/open/floor/plasteel,
/area/ruin/space/has_grav/drunk_driving)
"uq" = (
/obj/machinery/atmospherics/components/unary/shuttle/heater{
	dir = 4
	},
/obj/machinery/door/window/brigdoor/eastright,
/turf/open/floor/plating,
/area/ruin/space/has_grav/drunk_driving)
"vb" = (
/obj/structure/table,
/obj/item/multitool,
/turf/open/floor/plasteel/airless,
/area/ruin/space/has_grav/drunk_driving)
"ws" = (
/obj/machinery/atmospherics/pipe/simple/general/hidden{
	dir = 8
	},
/obj/effect/decal/cleanable/dirt/dust,
/obj/effect/decal/cleanable/dirt/dust,
/obj/effect/decal/cleanable/vomit/old,
/turf/open/floor/plasteel/airless,
/area/ruin/space/has_grav/drunk_driving)
"wA" = (
/obj/machinery/atmospherics/pipe/simple/general/hidden,
/obj/effect/decal/cleanable/generic,
/turf/open/floor/plasteel/airless,
/area/ruin/space/has_grav/drunk_driving)
"ze" = (
/obj/machinery/suit_storage_unit/standard_unit,
/turf/open/floor/plasteel,
/area/ruin/space/has_grav/drunk_driving)
"zv" = (
/obj/structure/table,
/turf/closed/mineral/random,
/area/ruin/space/has_grav/drunk_driving)
"zV" = (
/obj/machinery/atmospherics/components/unary/vent_pump,
/obj/machinery/atmospherics/pipe/simple/general/hidden{
	dir = 8
	},
/obj/effect/decal/cleanable/dirt/dust,
/obj/effect/turf_decal/stripes/red,
/turf/open/floor/plasteel,
/area/ruin/space/has_grav/drunk_driving)
"Af" = (
/obj/machinery/atmospherics/pipe/simple/general/hidden{
	dir = 8
	},
/turf/open/floor/plasteel,
/area/ruin/space/has_grav/drunk_driving)
"An" = (
/obj/machinery/atmospherics/components/unary/tank/air,
/obj/effect/decal/cleanable/plasma,
/turf/open/floor/plasteel/airless,
/area/ruin/space/has_grav/drunk_driving)
"Bj" = (
/obj/machinery/atmospherics/components/unary/vent_pump{
	dir = 8
	},
/turf/open/floor/plasteel/airless,
/area/ruin/space/has_grav/drunk_driving)
"Bx" = (
/obj/machinery/atmospherics/pipe/simple/general/hidden{
	dir = 8
	},
/obj/effect/turf_decal/stripes/red{
	dir = 8
	},
/turf/open/floor/plasteel/airless,
/area/ruin/space/has_grav/drunk_driving)
"Cm" = (
/turf/open/floor/plating,
/area/ruin/space/has_grav/drunk_driving)
"Cw" = (
/obj/machinery/atmospherics/pipe/simple/general/hidden{
	dir = 1
	},
/obj/item/storage/firstaid/regular,
/turf/open/floor/plasteel/airless,
/area/ruin/space/has_grav/drunk_driving)
"CC" = (
/obj/structure/table,
/obj/item/stack/cable_coil/cut,
/turf/open/floor/plasteel/airless,
/area/ruin/space/has_grav/drunk_driving)
"CI" = (
/obj/machinery/suit_storage_unit/standard_unit,
/obj/effect/decal/cleanable/dirt/dust,
/turf/open/floor/plasteel,
/area/ruin/space/has_grav/drunk_driving)
"CJ" = (
/obj/machinery/light/broken{
	dir = 4
	},
/obj/item/stack/sheet/mineral/plasma/five,
/obj/effect/decal/cleanable/dirt/dust,
/turf/open/floor/plasteel,
/area/ruin/space/has_grav/drunk_driving)
"DG" = (
/obj/effect/decal/cleanable/dirt/dust,
/obj/effect/decal/cleanable/oil/slippery,
/turf/open/floor/plasteel/airless,
/area/ruin/space/has_grav/drunk_driving)
"Eb" = (
/obj/machinery/door/airlock/hatch,
/obj/machinery/atmospherics/pipe/simple/general/hidden,
/obj/effect/decal/cleanable/plasma,
/turf/open/floor/plasteel,
/area/ruin/space/has_grav/drunk_driving)
"El" = (
/obj/item/chair,
/turf/open/floor/plasteel/airless,
/area/ruin/space/has_grav/drunk_driving)
"Em" = (
/obj/machinery/atmospherics/components/unary/vent_pump{
	dir = 1
	},
/obj/machinery/atmospherics/pipe/simple/general/hidden{
	dir = 8
	},
/obj/effect/decal/cleanable/dirt/dust,
/obj/effect/decal/cleanable/oil/slippery,
/obj/effect/decal/cleanable/plasma,
/obj/effect/turf_decal/stripes/red{
	dir = 1
	},
/turf/open/floor/plasteel/airless,
/area/ruin/space/has_grav/drunk_driving)
"EW" = (
/obj/machinery/atmospherics/pipe/manifold/general/hidden,
/obj/effect/decal/cleanable/dirt/dust,
/turf/open/floor/plasteel/airless,
/area/ruin/space/has_grav/drunk_driving)
"Gm" = (
/obj/machinery/light/broken{
	dir = 8
	},
/turf/open/floor/plasteel/airless,
/area/ruin/space/has_grav/drunk_driving)
"Gn" = (
/obj/structure/chair{
	dir = 4
	},
/turf/open/floor/plasteel/airless{
	icon_state = "floorscorched2"
	},
/area/ruin/space/has_grav/drunk_driving)
"GG" = (
/obj/machinery/atmospherics/components/unary/tank/toxins,
/turf/open/floor/plasteel,
/area/ruin/space/has_grav/drunk_driving)
"GX" = (
/obj/machinery/atmospherics/pipe/simple/general/hidden{
	dir = 8
	},
/obj/machinery/light/broken{
	dir = 1
	},
/obj/effect/decal/cleanable/plasma,
/turf/open/floor/plasteel/airless{
	icon_state = "floorscorched2"
	},
/area/ruin/space/has_grav/drunk_driving)
"Ix" = (
/obj/machinery/door/airlock/hatch,
/obj/machinery/atmospherics/pipe/simple/general/hidden{
	dir = 4
	},
/obj/item/shard,
/turf/open/floor/plasteel,
/area/ruin/space/has_grav/drunk_driving)
"IL" = (
/obj/machinery/atmospherics/pipe/simple/general/hidden,
/obj/effect/decal/cleanable/glass,
/turf/open/floor/plasteel,
/area/ruin/space/has_grav/drunk_driving)
"IP" = (
/obj/structure/chair{
	dir = 8
	},
/obj/item/stack/sheet/mineral/titanium,
/turf/open/floor/plasteel/airless,
/area/ruin/space/has_grav/drunk_driving)
"IV" = (
/obj/effect/spawner/structure/window/shuttle,
/turf/open/floor/plating,
/area/ruin/space/has_grav/drunk_driving)
"IY" = (
/obj/item/shard,
/obj/effect/decal/cleanable/glass,
/turf/open/floor/plasteel/airless,
/area/ruin/space/has_grav/drunk_driving)
"Kq" = (
/obj/machinery/atmospherics/pipe/simple/general/hidden,
/obj/effect/decal/cleanable/vomit/old,
/obj/effect/turf_decal/stripes/red,
/turf/open/floor/plasteel/airless,
/area/ruin/space/has_grav/drunk_driving)
"KL" = (
/obj/machinery/atmospherics/pipe/simple/general/hidden{
	dir = 8
	},
/obj/machinery/light/broken,
/obj/effect/decal/cleanable/dirt/dust,
/obj/item/wirecutters,
/turf/open/floor/plasteel,
/area/ruin/space/has_grav/drunk_driving)
"Lr" = (
/obj/effect/decal/cleanable/dirt/dust,
/turf/open/floor/plasteel/airless,
/area/ruin/space/has_grav/drunk_driving)
"LA" = (
/obj/machinery/door/airlock/external,
/turf/open/floor/plating,
/area/ruin/space/has_grav/drunk_driving)
"LN" = (
/turf/closed/mineral/random,
/area/ruin/space/has_grav/drunk_driving)
"Mq" = (
/obj/machinery/power/terminal{
	dir = 1
	},
/obj/effect/decal/cleanable/glass,
/turf/open/floor/plasteel/airless,
/area/ruin/space/has_grav/drunk_driving)
"Nb" = (
/obj/machinery/door/airlock/hatch,
/obj/machinery/atmospherics/pipe/simple/general/hidden{
	dir = 8
	},
/turf/open/floor/plasteel,
/area/ruin/space/has_grav/drunk_driving)
"Ni" = (
/obj/machinery/atmospherics/pipe/simple/general/hidden{
	dir = 8
	},
/obj/effect/decal/cleanable/dirt/dust,
/obj/effect/decal/cleanable/oil/slippery,
/obj/effect/turf_decal/stripes/red{
	dir = 4
	},
/turf/open/floor/plasteel,
/area/ruin/space/has_grav/drunk_driving)
"NR" = (
/obj/item/stack/sheet/mineral/bananium,
/obj/effect/decal/cleanable/dirt/dust,
/turf/open/floor/plasteel,
/area/ruin/space/has_grav/drunk_driving)
"OD" = (
/obj/machinery/power/smes,
/obj/structure/cable{
	icon_state = "0-8"
	},
/obj/machinery/light/broken{
	dir = 1
	},
/turf/open/floor/plasteel/airless,
/area/ruin/space/has_grav/drunk_driving)
"OP" = (
/obj/structure/chair{
	dir = 4
	},
/obj/item/reagent_containers/food/drinks/bottle/vodka/badminka,
/obj/effect/decal/cleanable/blood,
/obj/effect/decal/cleanable/vomit/old,
/obj/effect/gibspawner/human,
/turf/open/floor/plasteel/airless,
/area/ruin/space/has_grav/drunk_driving)
"OU" = (
/obj/structure/frame/computer{
	anchored = 1
	},
/obj/item/shard,
/turf/open/floor/plasteel/airless,
/area/ruin/space/has_grav/drunk_driving)
"Pm" = (
/obj/machinery/atmospherics/pipe/simple/general/hidden,
/turf/open/floor/plasteel,
/area/ruin/space/has_grav/drunk_driving)
"RG" = (
/obj/machinery/door/airlock/hatch,
/obj/machinery/atmospherics/pipe/simple/general/hidden,
/turf/open/floor/plasteel,
/area/ruin/space/has_grav/drunk_driving)
"Si" = (
/turf/open/floor/plasteel/airless,
/area/ruin/space/has_grav/drunk_driving)
"TK" = (
/obj/machinery/atmospherics/pipe/manifold/general/hidden,
/obj/effect/decal/cleanable/vomit/old,
/obj/effect/turf_decal/stripes/red{
	dir = 8
	},
/turf/open/floor/plasteel,
/area/ruin/space/has_grav/drunk_driving)
"Ur" = (
/obj/machinery/atmospherics/pipe/simple/general/hidden{
	dir = 8
	},
/obj/effect/decal/cleanable/dirt/dust,
/turf/open/floor/plasteel/airless,
/area/ruin/space/has_grav/drunk_driving)
"UI" = (
/obj/machinery/atmospherics/pipe/simple/general/hidden{
	dir = 4
	},
/obj/effect/decal/cleanable/dirt/dust,
/obj/item/stack/cable_coil/cut,
/turf/open/floor/plasteel/airless,
/area/ruin/space/has_grav/drunk_driving)
"UR" = (
/obj/machinery/atmospherics/pipe/simple/general/hidden{
	dir = 4
	},
/obj/effect/decal/cleanable/vomit/old,
/obj/effect/turf_decal/stripes/red{
	dir = 8
	},
/turf/open/floor/plasteel/airless,
/area/ruin/space/has_grav/drunk_driving)
"UU" = (
/obj/machinery/advanced_airlock_controller{
	pixel_y = 24
	},
/obj/machinery/atmospherics/components/unary/vent_pump{
	dir = 4
	},
/turf/open/floor/plating,
/area/ruin/space/has_grav/drunk_driving)
"WE" = (
/obj/structure/girder,
/turf/open/floor/plating,
/area/ruin/space/has_grav/drunk_driving)
"Xp" = (
/obj/item/shard,
/obj/machinery/light/broken{
	dir = 8
	},
/turf/open/floor/plasteel/airless,
/area/ruin/space/has_grav/drunk_driving)
"XU" = (
/obj/machinery/atmospherics/pipe/simple/general/hidden{
	dir = 4
	},
/obj/item/stack/sheet/mineral/titanium,
/obj/effect/spawner/lootdrop/donkpockets,
/obj/effect/decal/cleanable/oil/slippery,
/obj/effect/turf_decal/stripes/red{
	dir = 4
	},
/turf/open/floor/plasteel/airless,
/area/ruin/space/has_grav/drunk_driving)
"Yd" = (
/obj/item/stack/sheet/mineral/titanium,
/turf/open/floor/plasteel/airless,
/area/ruin/space/has_grav/drunk_driving)
"Yv" = (
/obj/structure/frame/computer{
	anchored = 1;
	dir = 8
	},
/turf/closed/mineral/random,
/area/ruin/space/has_grav/drunk_driving)

(1,1,1) = {"
hN
hN
hN
hN
hN
hN
hN
hN
hN
hN
hN
hN
hN
hN
hN
hN
hN
hN
hN
hN
"}
(2,1,1) = {"
hN
hN
hN
hN
hN
hN
hN
hN
hN
hN
hN
hN
hN
hN
hN
hN
hN
hN
hN
hN
"}
(3,1,1) = {"
hN
hN
hN
hN
hN
hN
hN
hN
hN
hN
hN
hN
hN
hN
hN
hN
hN
hN
hN
hN
"}
(4,1,1) = {"
hN
hN
ak
aS
ak
hN
hN
hN
ak
LA
ak
hN
hN
hN
ak
aS
ak
hN
hN
hN
"}
(5,1,1) = {"
hN
hN
ak
uq
ak
hN
hN
ak
ak
UU
ak
ak
hN
hN
ak
uq
ak
hN
hN
hN
"}
(6,1,1) = {"
hN
hN
ak
Af
ak
hN
ak
ak
ak
hx
ak
ak
ak
hN
ak
Bx
ak
hN
hN
hN
"}
(7,1,1) = {"
hN
hN
ak
Af
ak
hN
ak
ze
pO
TK
NR
fi
ak
hN
ak
Ur
ak
hN
hN
hN
"}
(8,1,1) = {"
hN
hN
ak
Af
ak
hN
ak
CI
CJ
Ni
pL
kr
ak
hN
ak
oF
ak
hN
hN
hN
"}
(9,1,1) = {"
hN
hN
ak
up
ak
IV
ak
ak
ak
Nb
ak
ak
ak
IV
ak
ef
ak
hN
hN
hN
"}
(10,1,1) = {"
hN
hN
ak
zV
RG
Pm
RG
ma
wA
tK
ov
Kq
RG
IL
Eb
Em
ak
hN
hN
hN
"}
(11,1,1) = {"
hN
hN
ak
KL
ak
IV
ak
OD
Mq
ws
Lr
bg
ak
IV
ak
GX
WE
hN
hN
hN
"}
(12,1,1) = {"
hN
hN
ak
mk
ak
hN
ak
kc
DG
bb
Cw
An
ak
hN
Cm
mX
Cm
hN
hN
hN
"}
(13,1,1) = {"
hN
hN
ak
GG
ak
hN
ak
uc
Si
UI
Gn
rC
WE
hN
Cm
uo
ak
hN
hN
hN
"}
(14,1,1) = {"
hN
hN
ak
ak
ak
hN
ak
CC
lL
EW
bA
Yd
ak
hN
WE
ak
WE
hN
hN
hN
"}
(15,1,1) = {"
hN
hN
hN
hN
hN
hN
ak
ax
El
XU
IP
El
LN
LN
hN
hN
hN
hN
hN
hN
"}
(16,1,1) = {"
hN
hN
hN
hN
hN
hN
ak
ak
ak
Ix
ak
LN
LN
LN
LN
hN
LN
hN
hN
hN
"}
(17,1,1) = {"
hN
hN
hN
hN
hN
hN
ak
vb
Gm
UR
Xp
zv
LN
LN
LN
LN
LN
LN
hN
hN
"}
(18,1,1) = {"
hN
hN
hN
hN
hN
hN
et
OU
OP
Bj
hB
ei
sD
LN
LN
LN
LN
LN
hN
hN
"}
(19,1,1) = {"
hN
hN
hN
hN
hN
LN
sD
IV
kn
IY
Yv
sD
sD
LN
LN
LN
LN
LN
hN
hN
"}
(20,1,1) = {"
hN
hN
hN
hN
hN
LN
LN
IV
IV
IV
sD
sD
LN
LN
LN
LN
LN
LN
LN
hN
"}
(21,1,1) = {"
hN
hN
hN
hN
hN
LN
LN
LN
LN
LN
LN
LN
LN
LN
LN
LN
LN
LN
LN
hN
"}
(22,1,1) = {"
hN
hN
hN
hN
LN
LN
LN
LN
LN
LN
LN
LN
LN
LN
LN
LN
LN
LN
LN
hN
"}
(23,1,1) = {"
hN
hN
hN
hN
LN
LN
LN
LN
LN
LN
LN
LN
LN
LN
LN
LN
LN
LN
LN
hN
"}
(24,1,1) = {"
hN
hN
hN
hN
LN
LN
LN
LN
LN
LN
LN
LN
LN
LN
LN
LN
LN
LN
LN
hN
"}
(25,1,1) = {"
hN
hN
hN
hN
LN
LN
LN
LN
LN
LN
LN
LN
LN
LN
LN
LN
LN
LN
LN
hN
"}
(26,1,1) = {"
hN
hN
hN
hN
LN
LN
LN
LN
LN
LN
LN
LN
LN
LN
LN
LN
LN
LN
hN
hN
"}
(27,1,1) = {"
hN
hN
hN
hN
hN
LN
LN
LN
LN
LN
LN
LN
LN
LN
LN
LN
LN
LN
hN
hN
"}
(28,1,1) = {"
hN
hN
hN
hN
hN
hN
hN
LN
LN
LN
hN
LN
LN
LN
LN
hN
hN
hN
hN
hN
"}
(29,1,1) = {"
hN
hN
hN
hN
hN
hN
hN
LN
LN
LN
hN
hN
hN
hN
hN
hN
hN
hN
hN
hN
"}
(30,1,1) = {"
hN
hN
hN
hN
hN
hN
hN
hN
hN
hN
hN
hN
hN
hN
hN
hN
hN
hN
hN
hN
"}
