"aa" = (/turf/open/space/basic,/area/space)
"ab" = (/turf/closed/mineral,/area/ruin/space/has_grav)
"ae" = (/mob/living/simple_animal/hostile/asteroid/hivelord,/turf/open/floor/plating/asteroid/airless,/area/ruin/space/has_grav)
"af" = (/obj/item/stack/medical/bruise_pack,/turf/open/floor/plating/asteroid/airless,/area/ruin/space/has_grav)
"ag" = (/obj/item/stack/ore/gold{amount = 2; pixel_x = 13},/turf/open/floor/plating/asteroid/airless,/area/ruin/space/has_grav)
"ah" = (/obj/item/stack/ore/iron{amount = 15; pixel_x = 15; pixel_y = 5},/obj/item/stack/ore/titanium{amount = 10; pixel_x = 5; pixel_y = -2},/turf/open/floor/plating/asteroid/airless,/area/ruin/space/has_grav)
"aj" = (/obj/item/stack/ore/iron{amount = 20; pixel_x = -15; pixel_y = 10},/obj/item/stack/ore/silver{amount = 5; pixel_x = 7; pixel_y = -3},/obj/item/stack/ore/diamond{pixel_x = 5; pixel_y = 10},/obj/item/stack/ore/silver{amount = 10; pixel_x = 5; pixel_y = -10},/turf/open/floor/plating/asteroid/airless,/area/ruin/space/has_grav)
"al" = (/obj/item/stack/ore/titanium,/turf/open/floor/plating/asteroid/airless,/area/ruin/space/has_grav)
"ap" = (/obj/item/stack/ore/plasma{amount = 5; pixel_x = -15; pixel_y = -10},/obj/item/stack/ore/uranium{pixel_x = -10},/obj/item/stack/ore/silver{amount = 5; pixel_x = 6; pixel_y = 5},/turf/open/floor/plating/asteroid/airless,/area/ruin/space/has_grav)
"at" = (/obj/item/stack/medical/ointment,/turf/open/floor/plating/asteroid/airless,/area/ruin/space/has_grav)
"au" = (/turf/open/floor/plating/asteroid/airless,/area/ruin/space/has_grav)
"ay" = (/obj/item/mining_scanner,/turf/open/floor/plating/asteroid/airless,/area/ruin/space/has_grav)
"aC" = (/obj/item/stack/ore/gold{amount = 2; pixel_x = 13; pixel_y = 10},/turf/open/floor/plating/asteroid/airless,/area/ruin/space/has_grav)
"aD" = (/obj/item/pickaxe/drill,/turf/open/floor/plating/asteroid/airless,/area/ruin/space/has_grav)
"aK" = (/obj/item/stack/spacecash/c500,/turf/open/floor/plating/asteroid/airless,/area/ruin/space/has_grav)
"aQ" = (/turf/closed/mineral/random,/area/ruin/space/has_grav)
"aS" = (/obj/item/stack/ore/iron{amount = 15; pixel_x = -10; pixel_y = -4},/obj/item/stack/ore/silver{amount = 2; pixel_x = -16; pixel_y = -4},/obj/item/stack/ore/silver{amount = 5; pixel_x = -9; pixel_y = 5},/turf/open/floor/plating/asteroid/airless,/area/ruin/space/has_grav)
"aU" = (/obj/item/stack/ore/plasma{amount = 10; pixel_x = -10; pixel_y = -10},/turf/open/floor/plating/asteroid/airless,/area/ruin/space/has_grav)
"aV" = (/turf/open/floor/plating,/area/ruin/space/has_grav)
"aY" = (/obj/item/stack/ore/iron{amount = 5; pixel_x = -10; pixel_y = 3},/obj/item/stack/ore/bluespace_crystal{pixel_x = -5; pixel_y = 10},/turf/open/floor/plating/asteroid/airless,/area/ruin/space/has_grav)
"bF" = (/obj/item/trash/boritos,/turf/open/floor/plating,/area/ruin/space/has_grav)
"cZ" = (/mob/living/simple_animal/hostile/asteroid/goliath/beast/ancient,/turf/open/floor/plating/asteroid/airless,/area/ruin/space/has_grav)
"dR" = (/mob/living/simple_animal/hostile/whitesands/ranged/hunter,/turf/open/floor/plating,/area/ruin/space/has_grav)
"eG" = (/turf/closed/wall/rust,/area/ruin/space/has_grav)
"fr" = (/obj/item/stack/sheet/glass/fifty,/turf/open/floor/plating,/area/ruin/space/has_grav)
"gr" = (/turf/closed/wall/material,/area/ruin/space/has_grav)
"gS" = (/obj/structure/closet/crate,/turf/open/floor/plating,/area/ruin/space/has_grav)
"ha" = (/obj/structure/table,/turf/open/floor/plating,/area/ruin/space/has_grav)
"ht" = (/obj/effect/mob_spawn/human/corpse/whitesands/survivor,/turf/open/floor/plating/asteroid/airless,/area/ruin/space/has_grav)
"iS" = (/obj/machinery/portable_atmospherics/canister/air,/turf/open/floor/plating,/area/ruin/space/has_grav)
"jU" = (/turf/closed/mineral/random/labormineral,/area/ruin/space/has_grav)
"lc" = (/obj/item/reagent_containers/food/drinks/waterbottle/large/empty,/turf/open/floor/plating,/area/ruin/space/has_grav)
"oj" = (/obj/effect/mob_spawn/human/corpse/whitesands/survivor,/obj/item/grenade,/turf/open/floor/plating/asteroid/airless,/area/ruin/space/has_grav)
"pb" = (/obj/item/trash/can/food/beans,/turf/open/floor/plating,/area/ruin/space/has_grav)
"po" = (/turf/open/floor/plating/airless,/area/ruin/space/has_grav)
"py" = (/mob/living/simple_animal/hostile/asteroid/basilisk,/turf/open/floor/plating/airless,/area/ruin/space/has_grav)
"rw" = (/obj/structure/barricade/wooden,/turf/open/floor/plating,/area/ruin/space/has_grav)
"tr" = (/obj/effect/mob_spawn/human/corpse/cargo_tech,/turf/open/floor/plating/airless,/area/ruin/space/has_grav)
"uN" = (/obj/item/stack/medical/bruise_pack,/obj/structure/barricade/sandbags,/turf/open/floor/plating/asteroid/airless,/area/ruin/space/has_grav)
"zQ" = (/obj/machinery/portable_atmospherics/scrubber,/turf/open/floor/plating,/area/ruin/space/has_grav)
"zY" = (/obj/item/pickaxe,/turf/open/floor/plating/asteroid/airless,/area/ruin/space/has_grav)
"Aa" = (/obj/item/trash/pistachios,/turf/open/floor/plating,/area/ruin/space/has_grav)
"AV" = (/obj/structure/bed,/turf/open/floor/plating,/area/ruin/space/has_grav)
"BE" = (/mob/living/simple_animal/hostile/carp,/turf/open/space/basic,/area/space)
"CB" = (/obj/machinery/door/airlock/hatch,/turf/open/floor/plating/airless,/area/ruin/space/has_grav)
"Dz" = (/obj/effect/decal/cleanable/oil,/obj/machinery/door/airlock/hatch,/turf/open/floor/plating/airless,/area/ruin/space/has_grav)
"DJ" = (/turf/closed/mineral/random/high_chance,/area/ruin/space/has_grav)
"En" = (/mob/living/simple_animal/hostile/whitesands/survivor,/turf/open/floor/plating,/area/ruin/space/has_grav)
"GX" = (/obj/effect/mob_spawn/human/corpse/whitesands/survivor/hunter,/turf/open/floor/plating/asteroid/airless,/area/ruin/space/has_grav)
"IA" = (/obj/item/tank/internals/oxygen,/obj/item/tank/internals/oxygen,/obj/item/tank/jetpack/improvised,/turf/open/floor/plating,/area/ruin/space/has_grav)
"Lc" = (/obj/machinery/portable_atmospherics/pump,/turf/open/floor/plating,/area/ruin/space/has_grav)
"LO" = (/mob/living/simple_animal/hostile/asteroid/basilisk,/turf/open/floor/plating/asteroid/airless,/area/ruin/space/has_grav)
"Ny" = (/obj/machinery/door/airlock/hatch,/obj/structure/barricade/wooden,/turf/open/floor/plating/airless,/area/ruin/space/has_grav)
"OU" = (/obj/effect/decal/cleanable/oil/streak,/turf/open/floor/plating,/area/ruin/space/has_grav)
"Pg" = (/obj/structure/closet/crate,/turf/open/floor/plating/airless,/area/ruin/space/has_grav)
"QH" = (/obj/structure/flora/ash/space/voidmelon,/turf/open/floor/plating/asteroid/airless,/area/ruin/space/has_grav)
"Ux" = (/obj/item/radio/off,/turf/open/floor/plating,/area/ruin/space/has_grav)
"XU" = (/obj/machinery/power/port_gen/pacman,/turf/open/floor/plating,/area/ruin/space/has_grav)
"Yz" = (/obj/machinery/portable_atmospherics/canister/oxygen,/turf/open/floor/plating,/area/ruin/space/has_grav)
"YK" = (/obj/structure/barricade/sandbags,/turf/open/floor/plating/asteroid/airless,/area/ruin/space/has_grav)
"ZQ" = (/obj/item/trash/energybar,/turf/open/floor/plating,/area/ruin/space/has_grav)

(1,1,1) = {"
aaaaaaaaaaaaaaaaaaaaaaaaaaaaaaaaaaaaaaaaaaaaaaaaaaaaaaaaaaaaaaaaaaaaaaaaaaaaaaaaaaaaaaaaaaaaaaBEaaaaaaaaaaaaaaaaaaaaaaaa
aaaaaaaaaaaaaaaaaaaaaaaaaaaaaaaaaaaaaaaaaaaaaaaaaaaaaaaaaaaaaaaaaaaaaaaaaaaaaaaaaaaaaaaaaaaaaaaaaaaaaaaaaaaaaaaaaaaaaaaa
aaaaaaaaaaaaaaaaaaaaaaaaaaaaaaaaaaaaaaBEaaaaaaaaaaaaaaaaaaaaaaaaaaaaaaaaaaaaaaaaaaaaaaaaaaaaaaaaaaaaaaaaaaaaaaaaaaaaaaaa
aaaaaaaaaaaaaaaaaaaaaaaaaaaaaaaaaaaaaaaaaaaaaaaaaaaaaaaaaaaaaaaaaaaaaaaaaaaaaaaaaaaaaaaaaaaaaaaaaaaaaaaaaaaaaaaaaaaaaaaa
aaaaaaaaaaaaaaaaaaaaaaaaaaaaaaaaaaaaaaaaaaaaaajUjUaaaajUjUjUaQaaaaBEaajUjUjUjUaQaaaQaaaaaaaaaaaaaaaaaaaaaaaaaaaaaaaaaaaa
aaaaaaaaaaaaaaaaaaaaaaaaaaaaaaaaaaaaaaaaaajUjUjUjUjUjUjUjUaQaQaaaaaaaQjUjUjUjUaQaQaQaQaaaaaaaaaaaaaaaaaaaaaaaaaaaaaaaaaa
aaaaaaaaaaaaaaaaaaaaaaaaaaaaaaaajUjUjUjUjUjUjUjUjUjUjUaQaQjUauQHaujUjUjUjUjUjUjUjUjUjUaaaaaaaaaaaaaaaaaaaaaaaaaaaaaaaaaa
aaaaaaaaaaaaaaaaaaaaaaaaaaaajUjUjUjUjUjUaQjUjUaQaQjUjUjUauauauauGXjUjUjUaQaQjUjUjUjUjUjUjUjUaaaaaaaaaaaaaaaaaaaaaaaaaaaa
aaaaaaaaaaaaaaaaaaaaaaaajUjUjUjUjUjUjUjUjUjUjUjUjUjULOauojauauYKYKjUjUjUjUaQaQaQjUjUjUjUjUjUaQaQaaaaaaaaaaaaaaaaaaaaaaaa
aaaaaaaaaaaaaaaaaaaaaajUjUjUjUjUjUjUaQjUauauauauauauauaQaQaQaQaQauauaujUjUjUjUjUjUjUaQjUjUjUjUjUaaaaaaaaaaaaaaBEaaaaaaaa
aaaaaaaaaaaaaaaaaajUjUjUjUjUjUjUjUjUjUjUauauauauaQaQaQaQaQaQaQaQaQaQauauauaQaQaQjUjUaQjUjUjUjUjUaaaaaaaaaaaaaaaaaaaaaaaa
aaaaaaaaaaaaaaaaaajUjUjUaQaQaQauaQaQaQaQaQaQauauaQaQaQaQaQaQaQaQaQaQauauauauaQaQaQaQjUjUjUjUaQaQaQjUaaaaaaaaaaaaaaaaaaaa
aaaaaaaaaaaaaaaaaajUjUjUaQaQaQauaQaQauauauauauauaQaQaQaQjUjUaQDJaQaQaQauauaeauaQaQaQjUjUjUjUjUjUaQjUjUaaaaaaaaaaaaaaaaaa
aaaaaaaaaaaaaaaaaajUjUaQaQaQjUauauaQauauauauaQaQaQaQaQaQDJaQaQaQaQjUjUaQaQauauauauaQaQaQaQjUjUjUjUjUjUjUjUaaaaaaaaaaaaaa
aaaaaaaaaaaaaaaaaajUjUaQaQaQjUaQauauaQaQauauaQaQaQaQaQaQDJaQaQaQaQaQaQaQaQaQaQaQauauaujUjUjUjUaQaQaQjUjUjUaaaaaaaaaaaaaa
aaaaaaaaaaaaaaaaaaaajUjUaQjUjUaQaQauauaQauauaQaQaQaQaQaQDJaQaQDJDJaQaQaQaQaQaQaQauauaujUaQjUjUjUaQaQjUaQjUaaaaaaaaaaaaaa
aaaaaaaaaaaaaaaaaaaajUjUjUjUjUaQjUaQauauauauaQaQaQaQaQaQaQaQaQaQaQaQDJaQaQaQauauauaujUjUaQjUjUjUjUjUjUjUjUaaaaaaaaaaaaaa
aaaaaaaaaaaaaaaaaaaaaajUjUjUjUjUjUaQaQaQauauaQaQaQaQaQaQaQaQaQDJaQaQaQaQaQaQauauauaujUaQaQjUjUjUjUjUaQjUjUaaaajUaaaaaaaa
aaaaaaaaaaaaaaaaaaaajUjUaQjUjUaQaQaQaQaQauauaQaQaQaQaQaQDJaQaQDJDJaQaQaQaQaQaQauaujUjUaQaQaQjUaQjUjUaQjUaaaaaajUaaaaaaaa
aaaaaaaaaaaaaaaaaaaajUjUjUjUaQaQaQaQaQaQauauaQaQaQaQDJDJDJaQaQaQDJaQDJaQaQaQaQaQaujUjUjUjUaQaQjUjUjUaQaaaaaaaajUaaaaaaaa
aaaaaaaaaaaaaaaaaaaajUjUjUaQaQaQaQaQaQauauaQaQaQaQaQDJDJDJDJaQaQaQaQaQaQaQaQaQaQauauauaujUjUjUjUaQjUjUaaaaaaaaaaaaaaaaaa
aaaaaaaaaaaaaaaaaajUjUjUaQaQjUaQauaQauauauaQaQjUaQDJDJDJauauauauaQaQjUaQaQaQaQaQauauaQaQaQjUjUjUjUjUaaaaaaaaaaaaaaaaaaaa
aaaaaaaaaaaaaaaaaajUjUaQaQjUauauauauauauauaQaQaQaQaQDJauLOauauauaQaQaQaQaQaQaQaQaQauauaQaQaQjUaQjUjUaQaaaaaaaaaaaaaaaaaa
aaaaaaaaaaaaaaaaaajUjUaQaQaQauauauauauaeaQaQaQaQaQDJauauauauauauaQDJDJaQaQaQjUaQaQaQauaQaQaQjUaQjUaQjUaaaaBEaaaaaaaaaaaa
aaaaaaaaaaaaaaaaaaaQjUjUjUaQauaQaQaQaQaQaQaQaQaQaQDJauauauauauauauDJaQaQaQaQaQaQaQaQauauaQaQaQjUjUjUjUaaaaaaaaaaaaaaaaaa
aaaaaaaaaaaaaaaaaajUjUjUaQaQauaQaQaQaQaQaQaQaQaQaQDJauauauauauauauDJDJDJaQaQaQaQaQaQaQauaQaQaQjUjUaaaaaaaaaaaaaaaaaaaaaa
aaaaaaaaaaaaaaaaaajUjUjUaQaQauauauaQaQaQaQaQaQDJDJaQauauauauauauauQHauDJaQaQaQaQaQaQaQauaQjUaQaQjUjUaaaaaaaaaaaaaaaaaaaa
aaaaaaaaaaaaaaaaaajUjUjUaQaQauauauaQaQLOaQaQjUaQDJauauauauaucZauauauauDJaQaQaQaQjUaQaQauaQaQaQaQjUjUaaaaaaaaaaaaaaaaaaaa
aaaaaaaaaaaaaaaaaajUjUjUaQaQauauaQaQaQaQaQaQaQDJDJauauauauauauauauDJDJDJaQaQaQaQaQaQaQaQauaQaQjUjUjUaaaaaaaaaaaaaaaaaaaa
aaaaaaaaaaaaaaaaaajUaQjUaQaQauaQaQaQaQaQaQaQDJaQDJaQauQHauauauauauDJDJaQaQaQaQaQaQaQaQaQauaQaQjUjUjUaaaaaaaaaaaaaaaaaaaa
aaaaaaaaaaaaaaaaaajUjUjUaQaQauaQaQaQaQaQaQaQaQaQaQDJaeauauauauauaQDJDJaQaQaeaQaQaQaQaQaQauaQaQaQjUjUjUjUaaaaaaaaaaaaaaaa
aaaaaaaaaaBEaaaaaajUjUjUaQaQauaQaQaQaQaQaQaQaQaQaQDJauaQDJaQauauauaQaQaQaQaQaQaQaQjUaQaQauaQaQaQaQjUaaaaaaaaaaaaaaaaaaaa
aaaaaaaaaaaaaaaaaajUjUjUaQaQauauaQaQaQaQaQaQaQaQaQaQauaQDJaQaQauzYauaQaQaQDJaQaQaQaQaQaQauaQaQaQaQaQaQaaaaaaaaaaaaaaaaaa
aaaaaaaaaaaaaaaaaajUjUjUaQaQauaQaQaQaQaQaQaQaQaQaQaQaQaQaQaQaQaQauhtauauauDJaQaQaQaQauauauaQaQjUjUaQaQaaaaaaaaaaaaaaaaaa
aaaaaaaaaaaaaaaaaajUjUjUaQaQauauaQaQaQaQaQaQaQaQDJaQaQaQaQaQaQaQaQaQaQDJauauauauauauGXauaQjUjUaQaQaQaQaaaaaaaaaaaaaaaaaa
aaaaaaaaaaaaaaaaaajUjUjUaQaQayaDaQaQaQaQaQaQaQaQaQaQaQaQjUjUjUjUjUaQaQaQaQaQaQaQauLOaQaQaQjUaQaQaaaQaQaaaaaaaaaaaaaaaaaa
aaaaaaaaaaaaaaaaaaaaaaabababauaeahapaUaQaQaQaQaQjUjUjUjUAVaVaVjUjUjUaQaQaQDJaQaQaQaQaQaQaQaQjUjUaaaaaaaaaaaaaaaaaaaaaaaa
aaaaaaaaaaaaaaaaaajUjUjUaQaQaQaualajaSaQaQaQjUjUjUjUjUaVaVaVaVjUaVjUjUaQaQaQaQaQaQaQaQaQaQaQjUjUaaaaaaaaaaaaaaaaaaaaaaaa
aaaaaaaaaaaaaaaaaajUjUjUjUaQaQauaCagaYeGeGgreGeGeGgrhaAVaVaVaVpbaVjUjUaQaQaQaQaQaQaQaQaQaQaQjUjUaaaaaaaaaaaaaaaaaaaaaaaa
aaaaaaaaaaaaaaaaaajUjUjUaQjUaQauhtauaugraVaVaVaVXUgrhabFEnaVlcaVaVjUjUaQaQaQaQaQaQaQaQaQjUjUjUjUaaaaaaaaaaaaaaaaaaaaaaaa
aaaaaaaaaaaaaaaaaajUjUjUaQaQaQYKuNYKaueGfraVaVaVaVeGaVaVlcaVZQaVaVjUjUjUjUaQaQaQaQaQaQjUjUjUjUjUaaaaaaaaaaaaaaaaaaaaaaaa
aaaaaaaaaaaaaaaaaajUjUjUaQjUaQafatauauDzOUaVaVaVaVNyrwpbaVaVaVaVAVjUjUjUjUaQjUjUaQaQaQjUjUjUjUjUaaBEaaaaaaaaaaaaaaaaaaaa
aaaaaaaaaaaaaaaaaaaajUjUjUjUaQauauaKaueGiSzQUxaVaVeGrwgSaVZQdRAaaVaVjUjUjUjUjUjUjUjUjUjUjUjUjUaaaaaaaaaaaaaaaaaaaaaaaaaa
aaaaaaaaaaaaaaaaaaaajUjUaQaQaQauayaeaQeGiSLcaVIAYzeGaVEnaVaVgSaVAVaVjUjUjUjUjUjUjUjUjUjUjUjUaaaaaaaaaaaaaaaaaaaaaaaaaaaa
aaaaaaaaaaaaaaaaaaaaaajUjUjUaQauaDauaQgrgreGCBgreGeGaVgSaVaVaVjUjUjUjUjUjUjUjUjUjUjUjUjUaaaaaaaaaaaaaaaaaaaaaaaaaaaaaaaa
aaaaaaaaaaaaaaaaaaaajUjUjUjUjUauauaujUjUpopopopopoaQjUjUjUjUjUjUjUjUjUjUjUjUjUaaaaaaaaaaaaaaaaaaaaaaaaaaaaaaaaaaaaaaaaaa
aaaaaaaaaaaaaaaaaaaaaajUjUjUjUjUjUaujUjUpopopopopogrjUjUjUjUjUaaaaaaaajUjUjUjUaaaaaaaaaaaaaaaaaaaaaaaaaaaaaaaaaaaaaaaaaa
aaaaaaaaaaaaaaaaaaaaaajUjUjUjUjUauauauaQpopopopopograaaaaaaaaaaaaaaaaaaaaaaaaaaaaaaaaaaaaaaaaaaaaaaaaaaaaaaaaaaaaaaaaaaa
aaaaaaaaaaaaaaaaaaaaaaaaaajUjUjUauauauaupopopopopograaaaaaaaaaaaaaaaaaaaaaaaaaaaaaaaaaaaaaBEaaaaaaaaaaaaaaaaaaaaaaaaaaaa
aaaaaaaaaaaaaaaaaaaaaaaaaajUjUjUjUjUjUjUjUpypotrpoeGaaaaaaaaaaaaaaaaaaaaaaaaaaaaaaaaaaaaaaaaaaaaaaaaaaaaaaaaaaaaaaaaaaaa
aaaaaaaaaaaaaaaaaaaaaaaaaaaaaaaaaaaajUjUjUpoPgpopoeGaaaaaaaaBEaaaaaaaaaaaaaaaaaaaaaaaaaaaaaaaaaaaaaaaaaaaaaaaaaaaaaaaaaa
aaaaaaaaaaaaaaaaaaaaaaaaaaaaaaaaaaaaaajUjUjUPgPgpoeGeGeGaaaaaaaaaaaaaaaaaaaaaaaaaaaaaaaaaaaaaaaaaaaaaaaaaaaaaaaaaaaaaaaa
aaaaaaaaaaaaaaaaBEaaaaaaaaaaaaaaaaaaaaaajUjUpopopoCBpoCBaaaaaaaaaaaaaaaaaaaaaaaaaaaaaaaaaaaaaaaaaaaaaaaaaaaaaaaaaaaaaaaa
aaaaaaaaaaaaaaaaaaaaaaaaaaaaaaaaaaaaaaaaaajUpoPgpogrgrgrBEaaaaaaaaaaaaaaaaaaaaaaaaaaaaaaaaaaaaaaaaaaaaaaaaaaaaaaaaaaaaaa
aaaaaaaaaaaaaaaaaaaaaaaaaaaaaaaaaaaaaaaaaagrgrgrgrgraaaaaaaaaaaaaaaaaaaaaaaaaaaaaaaaaaaaaaaaaaaaaaaaaaaaaaaaaaaaaaaaaaaa
aaaaaaaaaaaaaaaaaaaaaaaaaaaaaaaaaaaaaaaaaaaaaaaaaaaaaaaaaaaaaaaaaaaaaaaaaaaaaaaaaaaaaaaaaaaaaaaaaaaaaaaaaaaaaaaaaaaaaaaa
aaaaaaaaaaaaaaaaaaaaaaaaaaaaaaaaaaaaaaaaaaaaaaaaaaaaaaaaaaaaaaaaaaaaaaaaaaaaaaaaaaaaaaaaaaaaaaaaaaaaaaaaaaaaaaaaaaaaaaaa
aaaaaaaaaaaaaaaaaaaaaaaaaaaaaaaaaaaaaaaaaaaaaaaaaaaaaaaaaaaaaaaaaaaaaaaaaaaaaaaaaaaaaaaaaaaaBEaaaaaaaaaaaaaaaaaaaaaaaaaa
aaaaaaaaaaaaaaaaaaaaaaaaaaaaaaaaaaaaaaaaaaaaaaaaaaaaaaaaaaaaaaaaaaaaaaaaaaaaaaaaaaaaaaaaaaaaaaaaaaaaaaaaaaaaaaaaaaaaaaaa
aaaaaaaaaaaaaaaaaaaaaaaaaaaaaaaaaaaaaaaaaaaaaaaaaaaaaaaaaaaaaaaaaaaaaaaaaaaaaaaaaaaaaaaaaaaaaaaaaaaaaaaaaaaaaaaaaaaaaaaa
"}
