//MAP CONVERTED BY dmm2tgm.py THIS HEADER COMMENT PREVENTS RECONVERSION, DO NOT REMOVE
"aa" = (
/turf/open/space/basic,
/area/space)
"ab" = (
/turf/closed/mineral,
/area/ruin/space/has_grav)
"ae" = (
/mob/living/simple_animal/hostile/asteroid/hivelord,
/turf/open/floor/plating/asteroid/airless,
/area/ruin/space/has_grav)
"af" = (
/obj/item/stack/medical/bruise_pack,
/turf/open/floor/plating/asteroid/airless,
/area/ruin/space/has_grav)
"ag" = (
/obj/item/stack/ore/gold{
	amount = 2;
	pixel_x = 13
	},
/turf/open/floor/plating/asteroid/airless,
/area/ruin/space/has_grav)
"al" = (
/obj/item/stack/ore/titanium,
/turf/open/floor/plating/asteroid/airless,
/area/ruin/space/has_grav)
"ao" = (
/obj/machinery/door/airlock/hatch,
/turf/open/floor/plating/airless,
/area/ruin/space/has_grav)
"at" = (
/obj/item/stack/medical/ointment,
/turf/open/floor/plating/asteroid/airless,
/area/ruin/space/has_grav)
"au" = (
/turf/open/floor/plating/asteroid/airless,
/area/ruin/space/has_grav)
"ay" = (
/obj/item/mining_scanner,
/turf/open/floor/plating/asteroid/airless,
/area/ruin/space/has_grav)
"aD" = (
/obj/item/pickaxe/drill,
/turf/open/floor/plating/asteroid/airless,
/area/ruin/space/has_grav)
"aQ" = (
/turf/closed/mineral/random,
/area/ruin/space/has_grav)
"aU" = (
/obj/item/stack/ore/plasma{
	amount = 10;
	pixel_x = -10;
	pixel_y = -10
	},
/turf/open/floor/plating/asteroid/airless,
/area/ruin/space/has_grav)
"bf" = (
/obj/machinery/portable_atmospherics/canister/oxygen,
/turf/open/floor/plating,
/area/ruin/space/has_grav)
"do" = (
/obj/effect/decal/remains/human,
/obj/item/pickaxe/drill,
/obj/item/mining_scanner,
/obj/item/clothing/suit/space/hardsuit/mining,
/turf/open/floor/plating/asteroid/airless,
/area/ruin/space/has_grav)
"ds" = (
/obj/effect/decal/cleanable/oil/streak,
/obj/effect/decal/cleanable/dirt/dust,
/turf/open/floor/plating,
/area/ruin/space/has_grav)
"dy" = (
/turf/open/floor/plating/airless,
/area/ruin/space/has_grav)
"dJ" = (
/turf/closed/wall/material,
/area/ruin/space/has_grav)
"ed" = (
/obj/effect/mob_spawn/human/miner/explorer,
/turf/open/floor/plating,
/area/ruin/space/has_grav)
"eg" = (
/obj/structure/barricade/sandbags,
/turf/open/floor/plating/asteroid/airless,
/area/ruin/space/has_grav)
"eR" = (
/obj/item/grenade,
/turf/open/floor/plating/asteroid/airless,
/area/ruin/space/has_grav)
"ff" = (
/obj/item/stack/ore/iron{
	amount = 5;
	pixel_x = -10;
	pixel_y = 3
	},
/turf/open/floor/plating/asteroid/airless,
/area/ruin/space/has_grav)
"go" = (
/obj/item/stack/ore/titanium{
	amount = 10;
	pixel_x = 5;
	pixel_y = -2
	},
/obj/effect/decal/cleanable/dirt/dust,
/turf/open/floor/plating/asteroid/airless,
/area/ruin/space/has_grav)
"hU" = (
/obj/machinery/portable_atmospherics/canister/air,
/turf/open/floor/plating,
/area/ruin/space/has_grav)
"hZ" = (
/obj/item/stack/ore/bluespace_crystal{
	pixel_x = -5;
	pixel_y = 10
	},
/turf/open/floor/plating/asteroid/airless,
/area/ruin/space/has_grav)
"ia" = (
/turf/closed/mineral/random/labormineral,
/area/ruin/space/has_grav)
"io" = (
/obj/item/stack/ore/iron{
	amount = 15;
	pixel_x = -10;
	pixel_y = -4
	},
/turf/open/floor/plating/asteroid/airless,
/area/ruin/space/has_grav)
"jQ" = (
/mob/living/simple_animal/hostile/asteroid/goliath/beast/ancient,
/turf/open/floor/plating/asteroid/airless,
/area/ruin/space/has_grav)
"kQ" = (
/obj/item/stack/sheet/glass/fifty,
/turf/open/floor/plating,
/area/ruin/space/has_grav)
"ll" = (
/obj/item/stack/medical/bruise_pack,
/turf/open/floor/plating/airless,
/area/ruin/space/has_grav)
"mz" = (
/turf/closed/wall/rust,
/area/ruin/space/has_grav)
"pj" = (
/obj/effect/mob_spawn/human/miner/explorer,
/turf/open/floor/plating/asteroid/airless,
/area/ruin/space/has_grav)
"pU" = (
/obj/item/stack/ore/gold{
	amount = 2;
	pixel_x = 13;
	pixel_y = 10
	},
/obj/effect/decal/cleanable/dirt/dust,
/turf/open/floor/plating/asteroid/airless,
/area/ruin/space/has_grav)
"qT" = (
/obj/effect/decal/cleanable/dirt/dust,
/turf/open/floor/plating/asteroid/airless,
/area/ruin/space/has_grav)
"rD" = (
/obj/structure/closet/crate,
/turf/open/floor/plating/airless,
/area/ruin/space/has_grav)
"su" = (
/obj/structure/closet/crate,
/turf/open/floor/plating,
/area/ruin/space/has_grav)
"sM" = (
/obj/item/trash/pistachios,
/turf/open/floor/plating,
/area/ruin/space/has_grav)
"ui" = (
/obj/machinery/suit_storage_unit/open,
/turf/open/floor/plating,
/area/ruin/space/has_grav)
"uD" = (
/obj/item/stack/ore/plasma{
	amount = 5;
	pixel_x = -15;
	pixel_y = -10
	},
/turf/open/floor/plating/asteroid/airless,
/area/ruin/space/has_grav)
"xB" = (
/obj/item/tank/internals/oxygen,
/obj/item/tank/internals/oxygen,
/obj/item/tank/jetpack/improvised,
/turf/open/floor/plating,
/area/ruin/space/has_grav)
"zc" = (
/obj/item/stack/ore/diamond{
	pixel_x = 5;
	pixel_y = 10
	},
/turf/open/floor/plating/asteroid/airless,
/area/ruin/space/has_grav)
"zW" = (
/obj/structure/barricade/wooden,
/turf/open/floor/plating,
/area/ruin/space/has_grav)
"Aj" = (
/obj/machinery/door/airlock/hatch,
/obj/structure/barricade/wooden,
/turf/open/floor/plating/airless,
/area/ruin/space/has_grav)
"Bp" = (
/obj/item/stack/ore/silver{
	amount = 5;
	pixel_x = 6;
	pixel_y = 5
	},
/turf/open/floor/plating/asteroid/airless,
/area/ruin/space/has_grav)
"BE" = (
/obj/item/stack/ore/silver{
	amount = 2;
	pixel_x = -16;
	pixel_y = -4
	},
/turf/open/floor/plating/asteroid/airless,
/area/ruin/space/has_grav)
"Ci" = (
/obj/item/radio/off,
/obj/effect/decal/cleanable/dirt/dust,
/turf/open/floor/plating,
/area/ruin/space/has_grav)
"Eq" = (
/mob/living/simple_animal/hostile/carp,
/turf/open/space/basic,
/area/space)
"FJ" = (
/obj/structure/bed,
/turf/open/floor/plating,
/area/ruin/space/has_grav)
"Gc" = (
/obj/effect/decal/cleanable/oil,
/obj/machinery/door/airlock/hatch,
/turf/open/floor/plating/airless,
/area/ruin/space/has_grav)
"GN" = (
/obj/machinery/power/port_gen/pacman,
/turf/open/floor/plating,
/area/ruin/space/has_grav)
"HP" = (
/obj/item/trash/energybar,
/turf/open/floor/plating,
/area/ruin/space/has_grav)
"IN" = (
/obj/item/trash/can/food/beans,
/turf/open/floor/plating,
/area/ruin/space/has_grav)
"IZ" = (
/obj/structure/flora/ash/space/voidmelon,
/turf/open/floor/plating/asteroid/airless,
/area/ruin/space/has_grav)
"JX" = (
/obj/item/stack/ore/uranium{
	pixel_x = -10
	},
/turf/open/floor/plating/asteroid/airless,
/area/ruin/space/has_grav)
"Mv" = (
/obj/item/stack/ore/iron{
	amount = 15;
	pixel_x = 15;
	pixel_y = 5
	},
/turf/open/floor/plating/asteroid/airless,
/area/ruin/space/has_grav)
"MI" = (
/obj/structure/table,
/turf/open/floor/plating,
/area/ruin/space/has_grav)
"Nw" = (
/mob/living/simple_animal/hostile/asteroid/basilisk,
/turf/open/floor/plating/asteroid/airless,
/area/ruin/space/has_grav)
"OO" = (
/obj/item/stack/ore/silver{
	amount = 5;
	pixel_x = 7;
	pixel_y = -3
	},
/turf/open/floor/plating/asteroid/airless,
/area/ruin/space/has_grav)
"Pw" = (
/turf/open/floor/plating,
/area/ruin/space/has_grav)
"Qy" = (
/mob/living/simple_animal/hostile/asteroid/basilisk,
/turf/open/floor/plating/airless,
/area/ruin/space/has_grav)
"Ro" = (
/obj/effect/decal/cleanable/dirt/dust,
/turf/open/floor/plating,
/area/ruin/space/has_grav)
"Sj" = (
/obj/item/trash/boritos,
/turf/open/floor/plating,
/area/ruin/space/has_grav)
"Tm" = (
/obj/item/reagent_containers/food/drinks/waterbottle/large/empty,
/turf/open/floor/plating,
/area/ruin/space/has_grav)
"Vs" = (
/turf/closed/mineral/random/high_chance,
/area/ruin/space/has_grav)
"WK" = (
/obj/machinery/portable_atmospherics/scrubber,
/turf/open/floor/plating,
/area/ruin/space/has_grav)
"YH" = (
/obj/effect/decal/cleanable/blood,
/obj/effect/mob_spawn/human/miner/explorer,
/turf/open/floor/plating/asteroid/airless,
/area/ruin/space/has_grav)
"YW" = (
/obj/effect/decal/cleanable/dirt/dust,
/turf/open/floor/plating/airless,
/area/ruin/space/has_grav)
"Zs" = (
/obj/machinery/portable_atmospherics/pump,
/turf/open/floor/plating,
/area/ruin/space/has_grav)
"ZE" = (
/obj/effect/mob_spawn/human/corpse/cargo_tech,
/turf/open/floor/plating/airless,
/area/ruin/space/has_grav)

(1,1,1) = {"
aa
aa
aa
aa
aa
aa
aa
aa
aa
aa
aa
aa
aa
aa
aa
aa
aa
aa
aa
aa
aa
aa
aa
aa
aa
aa
aa
aa
aa
aa
aa
aa
aa
aa
aa
aa
aa
aa
aa
aa
aa
aa
aa
aa
aa
aa
aa
aa
aa
aa
aa
aa
aa
aa
aa
aa
aa
aa
aa
aa
"}
(2,1,1) = {"
aa
aa
aa
aa
aa
aa
aa
aa
aa
aa
aa
aa
aa
aa
aa
aa
aa
aa
aa
aa
aa
aa
aa
aa
aa
aa
aa
aa
aa
aa
aa
aa
aa
aa
aa
aa
aa
aa
aa
aa
aa
aa
aa
aa
aa
aa
aa
aa
aa
aa
aa
aa
aa
aa
aa
aa
aa
aa
aa
aa
"}
(3,1,1) = {"
aa
aa
aa
aa
aa
aa
aa
aa
aa
aa
aa
aa
aa
aa
aa
aa
aa
aa
aa
aa
aa
aa
aa
aa
aa
aa
aa
aa
aa
aa
aa
aa
aa
aa
aa
aa
aa
aa
aa
aa
aa
aa
aa
aa
aa
aa
aa
aa
aa
aa
aa
aa
aa
aa
aa
aa
aa
aa
aa
aa
"}
(4,1,1) = {"
aa
aa
aa
aa
aa
aa
aa
aa
aa
aa
aa
aa
aa
aa
aa
aa
aa
aa
aa
aa
aa
aa
aa
aa
aa
aa
aa
aa
aa
aa
aa
aa
aa
aa
aa
aa
aa
aa
aa
aa
aa
aa
aa
aa
aa
aa
aa
aa
aa
aa
aa
aa
aa
aa
aa
aa
aa
aa
aa
aa
"}
(5,1,1) = {"
aa
aa
aa
aa
aa
aa
aa
aa
aa
aa
aa
aa
aa
aa
aa
aa
aa
aa
aa
aa
aa
aa
aa
aa
aa
aa
aa
aa
aa
aa
aa
aa
aa
aa
aa
aa
aa
aa
aa
aa
aa
aa
aa
aa
aa
aa
aa
aa
aa
aa
aa
aa
aa
aa
aa
aa
aa
aa
aa
aa
"}
(6,1,1) = {"
aa
aa
aa
aa
aa
aa
aa
aa
aa
aa
aa
aa
aa
aa
aa
aa
aa
aa
aa
aa
aa
aa
aa
aa
aa
aa
aa
aa
aa
aa
aa
Eq
aa
aa
aa
aa
aa
aa
aa
aa
aa
aa
aa
aa
aa
aa
aa
aa
aa
aa
aa
aa
aa
aa
aa
aa
aa
aa
aa
aa
"}
(7,1,1) = {"
aa
aa
aa
aa
aa
aa
aa
aa
aa
aa
aa
aa
aa
aa
aa
aa
aa
aa
aa
aa
aa
aa
aa
aa
aa
aa
aa
aa
aa
aa
aa
aa
aa
aa
aa
aa
aa
aa
aa
aa
aa
aa
aa
aa
aa
aa
aa
aa
aa
aa
aa
aa
aa
aa
aa
aa
aa
aa
aa
aa
"}
(8,1,1) = {"
aa
aa
aa
aa
aa
aa
aa
aa
aa
aa
aa
aa
aa
aa
aa
aa
aa
aa
aa
aa
aa
aa
aa
aa
aa
aa
aa
aa
aa
aa
aa
aa
aa
aa
aa
aa
aa
aa
aa
aa
aa
aa
aa
aa
aa
aa
aa
aa
aa
aa
aa
aa
aa
aa
aa
aa
aa
aa
aa
aa
"}
(9,1,1) = {"
aa
aa
aa
aa
aa
aa
aa
aa
aa
aa
aa
aa
aa
aa
aa
aa
aa
aa
aa
aa
aa
aa
aa
aa
aa
aa
aa
aa
aa
aa
aa
aa
aa
aa
aa
aa
aa
aa
aa
aa
aa
aa
aa
aa
aa
aa
aa
aa
aa
aa
aa
aa
Eq
aa
aa
aa
aa
aa
aa
aa
"}
(10,1,1) = {"
aa
aa
aa
aa
aa
aa
aa
aa
aa
aa
ia
ia
ia
ia
ia
aa
aa
aa
aa
aa
aa
ia
ia
ia
aQ
ia
ia
ia
ia
ia
ia
ia
ia
ia
ia
ia
aa
ia
ia
ia
ia
ia
aa
aa
aa
aa
aa
aa
aa
aa
aa
aa
aa
aa
aa
aa
aa
aa
aa
aa
"}
(11,1,1) = {"
aa
aa
aa
aa
aa
aa
aa
aa
aa
aa
ia
ia
ia
ia
ia
ia
ia
aa
ia
ia
ia
ia
ia
ia
ia
ia
ia
ia
ia
aQ
ia
ia
ia
ia
ia
ia
aa
ia
ia
ia
ia
ia
ia
ia
aa
ia
aa
aa
aa
aa
aa
aa
aa
aa
aa
aa
aa
aa
aa
aa
"}
(12,1,1) = {"
aa
aa
aa
aa
aa
aa
aa
aa
aa
ia
ia
ia
ia
aQ
aQ
ia
ia
ia
ia
ia
ia
ia
aQ
aQ
ia
ia
ia
ia
ia
ia
ia
ia
ia
ia
ia
ia
ab
ia
ia
ia
ia
ia
ia
ia
ia
ia
ia
ia
aa
aa
aa
aa
aa
aa
aa
aa
aa
aa
aa
aa
"}
(13,1,1) = {"
aa
aa
aa
aa
aa
aa
aa
aa
ia
ia
ia
aQ
aQ
aQ
aQ
aQ
ia
ia
aQ
ia
ia
aQ
aQ
aQ
ia
aQ
aQ
aQ
aQ
aQ
aQ
aQ
aQ
aQ
aQ
aQ
ab
aQ
ia
aQ
aQ
aQ
ia
aQ
ia
ia
ia
ia
aa
aa
aa
aa
aa
aa
aa
aa
aa
aa
aa
aa
"}
(14,1,1) = {"
aa
aa
aa
aa
aa
aa
aa
aa
ia
ia
ia
aQ
aQ
aQ
aQ
ia
ia
ia
ia
ia
aQ
aQ
ia
aQ
aQ
aQ
aQ
aQ
aQ
aQ
aQ
aQ
aQ
aQ
aQ
aQ
ab
aQ
aQ
ia
aQ
ia
ia
aQ
ia
ia
ia
ia
ia
ia
aa
aa
aa
aa
aa
aa
aa
aa
aa
aa
"}
(15,1,1) = {"
aa
aa
aa
aa
aa
aa
aa
ia
ia
ia
ia
aQ
aQ
ia
ia
ia
ia
ia
ia
aQ
aQ
ia
au
au
au
au
au
qT
au
au
au
au
au
au
au
au
au
aQ
aQ
aQ
aQ
aQ
aQ
aQ
aQ
ia
ia
ia
ia
ia
aa
aa
aa
aa
aa
aa
aa
aa
aa
aa
"}
(16,1,1) = {"
aa
aa
aa
aa
aa
aa
aa
ia
ia
ia
ia
au
au
au
aQ
aQ
aQ
ia
aQ
aQ
aQ
aQ
au
qT
aQ
aQ
qT
qT
au
aQ
aQ
aQ
au
aQ
au
au
ae
au
au
qT
eg
af
qT
au
au
au
ia
ia
ia
ia
aa
aa
aa
aa
aa
aa
aa
aa
aa
aa
"}
(17,1,1) = {"
aa
aa
aa
aa
aa
aa
ia
ia
ia
ia
ia
aQ
aQ
au
au
aQ
ia
ia
aQ
aQ
aQ
au
ay
au
aQ
aQ
au
au
aQ
aQ
aQ
aQ
aQ
aQ
aQ
aQ
au
au
au
au
eg
at
pj
qT
aD
au
ia
au
au
ia
aa
aa
aa
aa
aa
aa
aa
aa
aa
aa
"}
(18,1,1) = {"
aa
aa
aa
aa
aa
aa
ia
ia
ia
ia
ia
aQ
aQ
aQ
au
au
aQ
aQ
aQ
aQ
aQ
aQ
au
au
aQ
aQ
aQ
aQ
aQ
aQ
aQ
aQ
aQ
aQ
aQ
aQ
Bp
au
qT
qT
eg
qT
qT
ae
au
au
au
au
au
ia
aa
aa
aa
aa
aa
aa
aa
aa
aa
aa
"}
(19,1,1) = {"
aa
aa
aa
aa
aa
aa
ia
ia
ia
aQ
ia
aQ
au
au
aQ
qT
au
aQ
aQ
aQ
aQ
au
qT
au
aQ
aQ
aQ
aQ
aQ
aQ
aQ
aQ
aQ
aQ
aQ
aQ
au
au
au
au
au
au
au
aQ
aQ
ia
ia
au
au
ia
ia
aa
aa
aa
aa
aa
aa
aa
aa
aa
"}
(20,1,1) = {"
aa
aa
Eq
aa
aa
aa
ia
ia
ia
ia
ia
aQ
au
au
aQ
aQ
qT
aQ
aQ
aQ
au
au
qT
ae
aQ
aQ
aQ
Nw
aQ
aQ
aQ
aQ
aQ
aQ
aQ
aQ
aQ
aQ
mz
dJ
mz
Gc
mz
mz
dJ
ia
ia
aQ
au
ia
ia
ia
aa
aa
aa
aa
aa
aa
aa
aa
"}
(21,1,1) = {"
aa
aa
aa
aa
aa
aa
ia
aQ
ia
au
au
aQ
au
qT
qT
au
qT
au
au
au
au
qT
au
aQ
aQ
aQ
aQ
aQ
aQ
aQ
aQ
aQ
aQ
aQ
aQ
aQ
aQ
aQ
mz
ui
kQ
ds
hU
hU
dJ
dy
dy
dy
dy
ia
ia
ia
ia
aa
aa
aa
aa
aa
aa
aa
"}
(22,1,1) = {"
aa
aa
aa
aa
aa
ia
ia
ia
ia
au
au
aQ
qT
qT
au
au
au
au
au
au
aQ
aQ
aQ
aQ
aQ
aQ
aQ
aQ
aQ
aQ
aQ
aQ
aQ
aQ
aQ
aQ
aQ
aQ
dJ
ui
Pw
Pw
WK
Zs
mz
dy
YW
YW
dy
Qy
dy
ia
ia
ia
dJ
aa
aa
aa
aa
aa
"}
(23,1,1) = {"
aa
aa
aa
aa
aa
ia
ia
ia
ia
qT
qT
au
au
aQ
aQ
aQ
aQ
aQ
aQ
aQ
aQ
aQ
aQ
aQ
aQ
aQ
aQ
ia
aQ
Vs
aQ
aQ
aQ
aQ
aQ
aQ
aQ
ia
mz
ui
Pw
Ro
Ci
Pw
ao
dy
dy
dy
YW
YW
rD
rD
dy
dy
dJ
aa
aa
aa
aa
aa
"}
(24,1,1) = {"
aa
aa
aa
aa
ia
ia
ia
aQ
ia
au
qT
au
au
aQ
aQ
aQ
aQ
aQ
aQ
aQ
aQ
ia
aQ
aQ
aQ
aQ
Vs
aQ
Vs
aQ
aQ
aQ
aQ
aQ
aQ
aQ
aQ
ia
mz
Pw
Pw
Ro
Pw
xB
dJ
dy
YW
dy
ll
ZE
dy
rD
YW
rD
dJ
aa
aa
aa
aa
aa
"}
(25,1,1) = {"
aa
aa
aa
aa
ia
ia
ia
aQ
ia
au
aQ
aQ
aQ
aQ
aQ
aQ
aQ
aQ
aQ
aQ
aQ
aQ
aQ
aQ
aQ
aQ
Vs
Vs
Vs
Vs
aQ
aQ
aQ
aQ
Vs
aQ
ia
ia
mz
GN
Pw
Pw
Pw
bf
mz
YW
YW
dy
dy
dy
YW
dy
dy
dy
dJ
aa
aa
aa
aa
aa
"}
(26,1,1) = {"
aa
aa
aa
aa
aa
ia
ia
ia
ia
au
aQ
aQ
aQ
aQ
aQ
aQ
aQ
aQ
aQ
aQ
aQ
Vs
aQ
Vs
Vs
Vs
aQ
au
BE
aQ
Vs
Vs
aQ
aQ
aQ
aQ
ia
ia
dJ
dJ
mz
Aj
mz
mz
mz
aQ
dJ
dJ
dJ
mz
mz
mz
ao
dJ
dJ
aa
aa
aa
aa
aa
"}
(27,1,1) = {"
aa
aa
aa
aa
aa
ia
ia
ia
Nw
au
aQ
aQ
aQ
aQ
aQ
aQ
aQ
aQ
aQ
Vs
Vs
Vs
Vs
au
zc
ag
aU
qT
qT
au
ae
hZ
au
aQ
aQ
aQ
ia
ia
MI
MI
Pw
zW
zW
Pw
Pw
ia
ia
aa
aa
aa
aa
mz
dy
dJ
aa
aa
aa
aa
aa
aa
"}
(28,1,1) = {"
aa
aa
aa
aa
ia
ia
aQ
ia
au
aQ
aQ
aQ
aQ
aQ
aQ
aQ
aQ
aQ
aQ
Vs
Vs
Vs
au
ff
au
au
au
au
qT
IZ
au
aQ
aQ
aQ
aQ
aQ
ia
Pw
FJ
Sj
Pw
IN
su
Pw
su
ia
ia
aa
aa
aa
aa
mz
ao
dJ
aa
aa
aa
aa
aa
aa
"}
(29,1,1) = {"
aa
aa
aa
aa
ia
ia
aQ
au
eR
aQ
aQ
aQ
ia
Vs
Vs
Vs
aQ
aQ
Vs
Vs
Vs
au
Nw
au
go
au
au
JX
au
qT
JX
Vs
Vs
aQ
aQ
ia
FJ
Pw
Pw
Pw
Tm
Pw
Pw
Pw
Pw
ia
ia
aa
aa
aa
aa
aa
aa
Eq
aa
aa
aa
aa
aa
aa
"}
(30,1,1) = {"
aa
aa
aa
aa
ia
aQ
ia
au
YH
aQ
aQ
aQ
ia
aQ
aQ
aQ
aQ
aQ
aQ
aQ
Vs
OO
au
au
au
au
hZ
qT
do
al
au
aQ
aQ
aQ
aQ
ia
Pw
Pw
ed
Pw
Pw
Pw
HP
Pw
Pw
ia
ia
aa
aa
aa
aa
aa
aa
aa
aa
aa
aa
aa
aa
aa
"}
(31,1,1) = {"
aa
aa
aa
aa
aQ
aQ
au
au
au
aQ
aQ
aQ
aQ
aQ
aQ
aQ
aQ
aQ
aQ
aQ
aQ
au
au
Bp
au
au
au
jQ
au
au
qT
OO
aQ
aQ
aQ
ia
Pw
Pw
Pw
Tm
HP
Pw
ed
su
Pw
ia
ia
aa
aa
aa
Eq
aa
aa
aa
aa
aa
aa
aa
aa
aa
"}
(32,1,1) = {"
aa
aa
aa
aa
aa
aa
IZ
qT
eg
aQ
aQ
aQ
Vs
aQ
aQ
Vs
aQ
Vs
Vs
aQ
Vs
au
au
au
BE
au
au
qT
au
io
au
Mv
au
aQ
aQ
ia
ia
ia
IN
Pw
Pw
Pw
sM
Pw
ia
ia
aa
aa
aa
aa
aa
aa
aa
aa
aa
aa
aa
aa
aa
aa
"}
(33,1,1) = {"
aa
aa
aa
aa
aa
aa
qT
au
eg
au
aQ
aQ
aQ
aQ
aQ
Vs
aQ
aQ
Vs
Vs
aQ
au
aQ
aQ
uD
au
au
pU
au
Mv
aQ
au
au
qT
aQ
ia
ia
Pw
Pw
Pw
Pw
FJ
Pw
FJ
ia
ia
aa
aa
aa
aa
aa
aa
aa
aa
aa
aa
aa
aa
aa
aa
"}
(34,1,1) = {"
aa
aa
aa
aa
Eq
aa
ia
ia
ia
au
aQ
aQ
aQ
ia
aQ
aQ
aQ
aQ
aQ
aQ
aQ
aQ
aQ
Vs
Vs
Vs
IZ
au
Vs
Vs
Vs
aQ
au
qT
aQ
aQ
ia
ia
ia
ia
ia
ia
Pw
Pw
ia
ia
aa
aa
aa
aa
aa
aa
aa
aa
aa
aa
aa
aa
aa
aa
"}
(35,1,1) = {"
aa
aa
aa
aa
aa
aQ
ia
ia
ia
au
au
au
aQ
ia
aQ
aQ
Vs
aQ
aQ
Vs
aQ
ia
aQ
Vs
aQ
Vs
au
uD
Vs
Vs
Vs
aQ
Vs
qT
aQ
aQ
aQ
ia
ia
ia
ia
ia
ia
ia
ia
ia
aa
aa
aa
aa
aa
aa
aa
aa
aa
aa
aa
aa
aa
aa
"}
(36,1,1) = {"
aa
aa
aa
aa
ia
ia
ia
ia
ia
ia
au
qT
au
aQ
aQ
aQ
aQ
aQ
aQ
aQ
aQ
aQ
aQ
aQ
aQ
Vs
Vs
Vs
Vs
aQ
aQ
aQ
aQ
au
Vs
aQ
aQ
aQ
aQ
aQ
ia
ia
ia
ia
ia
ia
ia
aa
aa
aa
aa
aa
aa
aa
aa
aa
aa
aa
aa
aa
"}
(37,1,1) = {"
aa
aa
aa
aa
ia
ia
ia
aQ
ia
ia
au
au
au
aQ
aQ
aQ
aQ
aQ
aQ
aQ
aQ
aQ
aQ
aQ
aQ
aQ
aQ
aQ
aQ
aQ
aQ
aQ
aQ
qT
au
aQ
aQ
aQ
aQ
aQ
ia
ia
ia
ia
ia
ia
ia
aa
aa
aa
aa
aa
aa
aa
aa
aa
aa
aa
aa
aa
"}
(38,1,1) = {"
aa
aa
aa
aa
ia
ia
ia
aQ
aQ
ia
aQ
au
ae
au
aQ
aQ
aQ
aQ
aQ
aQ
aQ
aQ
aQ
aQ
aQ
aQ
aQ
aQ
aQ
aQ
ae
aQ
Vs
Vs
au
aQ
Vs
aQ
aQ
aQ
aQ
aQ
ia
ia
ia
ia
ia
aa
aa
aa
aa
aa
aa
aa
aa
aa
aa
aa
aa
aa
"}
(39,1,1) = {"
aa
aa
aa
aa
ia
ia
ia
ia
aQ
ia
aQ
aQ
au
au
aQ
aQ
au
au
aQ
aQ
aQ
aQ
aQ
ia
aQ
aQ
aQ
aQ
aQ
aQ
aQ
aQ
aQ
aQ
au
aQ
aQ
aQ
aQ
aQ
aQ
ia
ia
ia
ia
ia
ia
aa
aa
aa
aa
aa
aa
aa
aa
aa
aa
aa
aa
aa
"}
(40,1,1) = {"
aa
aa
aa
aa
aQ
aQ
ia
ia
aQ
ia
aQ
aQ
aQ
au
Vs
aQ
au
au
au
aQ
Vs
aQ
aQ
aQ
aQ
aQ
aQ
aQ
aQ
aQ
aQ
aQ
aQ
aQ
au
aQ
aQ
aQ
aQ
aQ
aQ
ia
ia
ia
ia
aa
aa
aa
aa
aa
aa
aa
aa
aa
aa
aa
aa
aa
aa
aa
"}
(41,1,1) = {"
aa
aa
aa
aa
aa
aQ
ia
ia
ia
ia
ia
aQ
aQ
au
au
au
au
au
au
au
au
au
aQ
aQ
aQ
aQ
aQ
ia
aQ
aQ
aQ
aQ
aQ
aQ
au
au
aQ
aQ
aQ
aQ
aQ
aQ
ia
ia
ia
aa
aa
aa
aa
aa
aa
aa
aa
aa
aa
aa
aa
aa
aa
aa
"}
(42,1,1) = {"
aa
aa
aa
aa
aQ
aQ
ia
ia
ia
ia
ia
aQ
aQ
aQ
au
au
au
au
ia
ia
au
au
au
aQ
aQ
aQ
aQ
aQ
aQ
aQ
aQ
ia
aQ
aQ
au
Nw
aQ
aQ
aQ
aQ
aQ
aQ
ia
ia
ia
aa
aa
aa
aa
aa
aa
aa
aa
aa
aa
aa
aa
aa
aa
aa
"}
(43,1,1) = {"
aa
aa
aa
aa
aa
aQ
ia
ia
ia
aQ
aQ
ia
ia
aQ
au
au
ia
ia
ia
ia
au
aQ
au
au
au
aQ
aQ
aQ
aQ
aQ
aQ
aQ
aQ
au
au
aQ
aQ
aQ
aQ
aQ
aQ
aQ
ia
ia
ia
aa
aa
aa
aa
aa
aa
aa
aa
aa
aa
aa
aa
aa
aa
aa
"}
(44,1,1) = {"
aa
aa
aa
aa
aa
aa
aa
ia
ia
ia
ia
ia
ia
aQ
ia
ia
ia
aQ
aQ
ia
au
aQ
aQ
aQ
au
au
au
au
au
aQ
aQ
aQ
Vs
au
au
aQ
aQ
aQ
aQ
aQ
ia
ia
ia
ia
ia
aa
aa
aa
aa
aa
aa
aa
aa
aa
aa
aa
aa
aa
aa
aa
"}
(45,1,1) = {"
aa
aa
aa
aa
aa
aa
aa
ia
ia
ia
ia
ia
ia
aQ
ia
aQ
aQ
aQ
aQ
ia
ia
aQ
aQ
aQ
aQ
aQ
Vs
aQ
au
au
au
au
au
au
aQ
aQ
aQ
aQ
aQ
ia
ia
ia
ia
ia
aa
aa
aa
aa
aa
aa
aa
aa
aa
aa
aa
aa
aa
aa
aa
aa
"}
(46,1,1) = {"
aa
aa
aa
aa
aa
aa
aa
ia
ia
ia
ia
ia
ia
ia
ia
ia
ia
ia
aQ
aQ
ia
ia
aQ
aQ
aQ
aQ
ia
aQ
aQ
aQ
aQ
aQ
aQ
aQ
ia
ia
aQ
aQ
aQ
ia
ia
ia
ia
ia
aa
aa
aa
aa
Eq
aa
aa
aa
aa
aa
aa
aa
aa
aa
aa
aa
"}
(47,1,1) = {"
aa
aa
aa
aa
aa
aa
aa
aa
aQ
ia
ia
aQ
ia
ia
ia
ia
ia
ia
ia
aQ
ia
ia
ia
ia
aQ
aQ
aQ
aQ
aQ
aQ
aQ
aQ
aQ
aQ
ia
aQ
ia
ia
ia
ia
ia
ia
ia
aa
aa
aa
aa
aa
aa
aa
aa
aa
aa
aa
aa
aa
aa
Eq
aa
aa
"}
(48,1,1) = {"
Eq
aa
aa
aa
aa
aa
aa
aa
aQ
ia
ia
aQ
ia
ia
aQ
ia
ia
ia
aQ
ia
ia
ia
aQ
aQ
ia
ia
aQ
aQ
ia
ia
aQ
aQ
aQ
ia
aQ
aQ
ia
ia
ia
ia
ia
ia
aa
aa
aa
aa
aa
aa
aa
aa
aa
aa
aa
aa
aa
aa
aa
aa
aa
aa
"}
(49,1,1) = {"
aa
aa
aa
aa
aa
aa
aa
aa
aa
aa
aa
aQ
aQ
ia
aQ
aQ
ia
ia
ia
ia
aQ
ia
ia
ia
ia
ia
ia
ia
ia
ia
ia
aQ
aQ
ia
aQ
aa
aa
aa
aa
aa
aa
aa
aa
aa
aa
aa
aa
aa
aa
aa
aa
aa
aa
aa
aa
aa
aa
aa
aa
aa
"}
(50,1,1) = {"
aa
aa
aa
aa
aa
aa
aa
aa
aa
aa
aa
ia
ia
ia
aQ
aQ
ia
ia
ia
ia
ia
ia
ia
aQ
ia
aa
ia
ia
ia
ia
ia
ia
aQ
aQ
aQ
aQ
aa
aa
aa
aa
aa
Eq
aa
aa
aa
aa
aa
aa
aa
aa
aa
aa
aa
aa
aa
aa
aa
aa
aa
aa
"}
(51,1,1) = {"
aa
aa
aa
aa
aa
aa
aa
aa
aa
aa
aa
aa
ia
ia
ia
ia
ia
aQ
aQ
aQ
ia
aa
aQ
ia
ia
aa
aa
aa
aa
aa
ia
aa
aQ
aQ
aQ
aQ
aa
aa
aa
aa
aa
aa
aa
aa
aa
aa
aa
aa
aa
aa
aa
aa
aa
aa
aa
aa
aa
aa
aa
aa
"}
(52,1,1) = {"
aa
aa
aa
aa
aa
aa
aa
aa
aa
aa
aa
aa
aa
ia
ia
aQ
ia
ia
ia
aa
aa
aa
aa
aa
aa
aa
aa
aa
aa
aa
ia
aa
aa
aa
aa
aa
aa
aa
aa
aa
aa
aa
aa
aa
aa
aa
aa
aa
aa
aa
aa
aa
aa
aa
aa
aa
aa
aa
aa
aa
"}
(53,1,1) = {"
aa
aa
aa
aa
aa
aa
aa
aa
aa
aa
aa
aa
aa
ia
ia
ia
ia
ia
aa
aa
aa
aa
aa
aa
aa
aa
aa
aa
aa
aa
aa
aa
aa
aa
aa
aa
aa
aa
aa
aa
aa
aa
aa
aa
aa
aa
aa
aa
aa
aa
aa
aa
aa
aa
aa
aa
aa
aa
aa
aa
"}
(54,1,1) = {"
aa
aa
aa
aa
aa
aa
aa
aa
aa
aa
aa
aa
aa
aa
aa
aa
aa
aa
aa
aa
aa
aa
aa
Eq
aa
aa
aa
aa
aa
aa
aa
aa
aa
aa
aa
aa
aa
aa
aa
aa
aa
aa
aa
aa
aa
aa
aa
aa
aa
aa
aa
aa
aa
aa
aa
aa
aa
aa
aa
aa
"}
(55,1,1) = {"
aa
aa
aa
aa
aa
aa
aa
aa
aa
aa
aa
aa
aa
aa
aa
aa
aa
aa
aa
aa
aa
aa
aa
aa
aa
aa
aa
aa
aa
aa
aa
aa
aa
aa
aa
aa
aa
aa
aa
aa
aa
aa
aa
aa
aa
aa
aa
aa
aa
aa
aa
aa
aa
aa
aa
aa
aa
aa
aa
aa
"}
(56,1,1) = {"
aa
aa
aa
aa
aa
aa
aa
aa
aa
Eq
aa
aa
aa
aa
aa
aa
aa
ia
ia
ia
aa
aa
aa
aa
aa
aa
aa
aa
aa
aa
aa
aa
aa
aa
aa
aa
aa
aa
aa
aa
aa
aa
aa
aa
aa
aa
aa
aa
aa
aa
aa
aa
aa
aa
aa
aa
aa
aa
aa
aa
"}
(57,1,1) = {"
aa
aa
aa
aa
aa
aa
aa
aa
aa
aa
aa
aa
aa
aa
aa
aa
aa
aa
aa
aa
aa
aa
aa
aa
aa
aa
aa
aa
aa
aa
aa
aa
aa
aa
aa
aa
aa
aa
aa
aa
aa
aa
aa
aa
aa
aa
aa
aa
aa
aa
aa
aa
aa
aa
aa
aa
aa
aa
aa
aa
"}
(58,1,1) = {"
aa
aa
aa
aa
aa
aa
aa
aa
aa
aa
aa
aa
aa
aa
aa
aa
aa
aa
aa
aa
aa
aa
aa
aa
aa
aa
aa
aa
aa
aa
aa
aa
aa
aa
aa
aa
aa
aa
aa
aa
aa
aa
aa
aa
aa
aa
aa
aa
aa
aa
aa
aa
aa
aa
aa
aa
aa
aa
aa
aa
"}
(59,1,1) = {"
aa
aa
aa
aa
aa
aa
aa
aa
aa
aa
aa
aa
aa
aa
aa
aa
aa
aa
aa
aa
aa
aa
aa
aa
aa
aa
aa
aa
aa
aa
aa
aa
aa
aa
aa
aa
aa
aa
aa
aa
aa
aa
aa
aa
aa
aa
aa
aa
aa
aa
aa
aa
aa
aa
aa
aa
aa
aa
aa
aa
"}
(60,1,1) = {"
aa
aa
aa
aa
aa
aa
aa
aa
aa
aa
aa
aa
aa
aa
aa
aa
aa
aa
aa
aa
aa
aa
aa
aa
aa
aa
aa
aa
aa
aa
aa
aa
aa
aa
aa
aa
aa
aa
aa
aa
aa
aa
aa
aa
aa
aa
aa
aa
aa
aa
aa
aa
aa
aa
aa
aa
aa
aa
aa
aa
"}
