//MAP CONVERTED BY dmm2tgm.py THIS HEADER COMMENT PREVENTS RECONVERSION, DO NOT REMOVE
"aa" = (
/turf/open/space/basic,
/area/space)
"ab" = (
/turf/closed/mineral,
/area/ruin/space/has_grav)
"ae" = (
/mob/living/simple_animal/hostile/asteroid/hivelord,
/turf/open/floor/plating/asteroid/airless,
/area/ruin/space/has_grav)
"af" = (
/obj/item/stack/medical/bruise_pack,
/turf/open/floor/plating/asteroid/airless,
/area/ruin/space/has_grav)
"ag" = (
/obj/item/stack/ore/gold{
	amount = 2;
	pixel_x = 13
	},
/turf/open/floor/plating/asteroid/airless,
/area/ruin/space/has_grav)
"ah" = (
/obj/item/stack/ore/iron{
	amount = 15;
	pixel_x = 15;
	pixel_y = 5
	},
/obj/item/stack/ore/titanium{
	amount = 10;
	pixel_x = 5;
	pixel_y = -2
	},
/turf/open/floor/plating/asteroid/airless,
/area/ruin/space/has_grav)
"aj" = (
/obj/item/stack/ore/iron{
	amount = 20;
	pixel_x = -15;
	pixel_y = 10
	},
/obj/item/stack/ore/silver{
	amount = 5;
	pixel_x = 7;
	pixel_y = -3
	},
/obj/item/stack/ore/diamond{
	pixel_x = 5;
	pixel_y = 10
	},
/obj/item/stack/ore/silver{
	amount = 10;
	pixel_x = 5;
	pixel_y = -10
	},
/turf/open/floor/plating/asteroid/airless,
/area/ruin/space/has_grav)
"al" = (
/obj/item/stack/ore/titanium,
/turf/open/floor/plating/asteroid/airless,
/area/ruin/space/has_grav)
"ap" = (
/obj/item/stack/ore/plasma{
	amount = 5;
	pixel_x = -15;
	pixel_y = -10
	},
/obj/item/stack/ore/uranium{
	pixel_x = -10
	},
/obj/item/stack/ore/silver{
	amount = 5;
	pixel_x = 6;
	pixel_y = 5
	},
/turf/open/floor/plating/asteroid/airless,
/area/ruin/space/has_grav)
"at" = (
/obj/item/stack/medical/ointment,
/turf/open/floor/plating/asteroid/airless,
/area/ruin/space/has_grav)
"au" = (
/turf/open/floor/plating/asteroid/airless,
/area/ruin/space/has_grav)
"ay" = (
/obj/item/mining_scanner,
/turf/open/floor/plating/asteroid/airless,
/area/ruin/space/has_grav)
"aC" = (
/obj/item/stack/ore/gold{
	amount = 2;
	pixel_x = 13;
	pixel_y = 10
	},
/turf/open/floor/plating/asteroid/airless,
/area/ruin/space/has_grav)
"aD" = (
/obj/item/pickaxe/drill,
/turf/open/floor/plating/asteroid/airless,
/area/ruin/space/has_grav)
"aK" = (
/obj/item/stack/spacecash/c500,
/turf/open/floor/plating/asteroid/airless,
/area/ruin/space/has_grav)
"aQ" = (
/turf/closed/mineral/random,
/area/ruin/space/has_grav)
"aS" = (
/obj/item/stack/ore/iron{
	amount = 15;
	pixel_x = -10;
	pixel_y = -4
	},
/obj/item/stack/ore/silver{
	amount = 2;
	pixel_x = -16;
	pixel_y = -4
	},
/obj/item/stack/ore/silver{
	amount = 5;
	pixel_x = -9;
	pixel_y = 5
	},
/turf/open/floor/plating/asteroid/airless,
/area/ruin/space/has_grav)
"aU" = (
/obj/item/stack/ore/plasma{
	amount = 10;
	pixel_x = -10;
	pixel_y = -10
	},
/turf/open/floor/plating/asteroid/airless,
/area/ruin/space/has_grav)
"aY" = (
/obj/item/stack/ore/iron{
	amount = 5;
	pixel_x = -10;
	pixel_y = 3
	},
/obj/item/stack/ore/bluespace_crystal{
	pixel_x = -5;
	pixel_y = 10
	},
/turf/open/floor/plating/asteroid/airless,
/area/ruin/space/has_grav)
"ba" = (
/obj/structure/bed,
/turf/open/floor/plating,
/area/ruin/space/has_grav)
"da" = (
/obj/item/trash/boritos,
/turf/open/floor/plating,
/area/ruin/space/has_grav)
"dV" = (
/turf/open/floor/plating/airless,
/area/ruin/space/has_grav)
"ez" = (
/obj/machinery/portable_atmospherics/pump,
/turf/open/floor/plating,
/area/ruin/space/has_grav)
"fd" = (
/obj/structure/closet/crate,
/turf/open/floor/plating,
/area/ruin/space/has_grav)
"hI" = (
/mob/living/simple_animal/hostile/whitesands/ranged/hunter,
/turf/open/floor/plating,
/area/ruin/space/has_grav)
"iT" = (
/obj/item/stack/medical/bruise_pack,
/obj/structure/barricade/sandbags,
/turf/open/floor/plating/asteroid/airless,
/area/ruin/space/has_grav)
"kT" = (
/obj/machinery/portable_atmospherics/canister/air,
/turf/open/floor/plating,
/area/ruin/space/has_grav)
"lu" = (
/obj/item/tank/internals/oxygen,
/obj/item/tank/internals/oxygen,
/obj/item/tank/jetpack/improvised,
/turf/open/floor/plating,
/area/ruin/space/has_grav)
"lL" = (
/obj/machinery/door/airlock/hatch,
/turf/open/floor/plating/airless,
/area/ruin/space/has_grav)
"rF" = (
/obj/effect/mob_spawn/human/corpse/cargo_tech,
/turf/open/floor/plating/airless,
/area/ruin/space/has_grav)
"sN" = (
/obj/structure/flora/ash/space/voidmelon,
/turf/open/floor/plating/asteroid/airless,
/area/ruin/space/has_grav)
"tr" = (
/turf/closed/mineral/random/labormineral,
/area/ruin/space/has_grav)
"tA" = (
/turf/closed/wall/material,
/area/ruin/space/has_grav)
"wo" = (
/obj/machinery/portable_atmospherics/canister/oxygen,
/turf/open/floor/plating,
/area/ruin/space/has_grav)
"wK" = (
/obj/machinery/power/port_gen/pacman,
/turf/open/floor/plating,
/area/ruin/space/has_grav)
"wT" = (
/obj/item/pickaxe,
/turf/open/floor/plating/asteroid/airless,
/area/ruin/space/has_grav)
"xH" = (
/obj/effect/decal/cleanable/oil/streak,
/turf/open/floor/plating,
/area/ruin/space/has_grav)
"ys" = (
/obj/machinery/door/airlock/hatch,
/obj/structure/barricade/wooden,
/turf/open/floor/plating/airless,
/area/ruin/space/has_grav)
"yM" = (
/turf/open/floor/plating,
/area/ruin/space/has_grav)
"yP" = (
/mob/living/simple_animal/hostile/asteroid/goliath/beast/ancient,
/turf/open/floor/plating/asteroid/airless,
/area/ruin/space/has_grav)
"zP" = (
/obj/item/stack/sheet/glass/fifty,
/turf/open/floor/plating,
/area/ruin/space/has_grav)
"Av" = (
/mob/living/simple_animal/hostile/carp,
/turf/open/space/basic,
/area/space)
"BD" = (
/obj/item/radio/off,
/turf/open/floor/plating,
/area/ruin/space/has_grav)
"FU" = (
/obj/effect/decal/cleanable/oil,
/obj/machinery/door/airlock/hatch,
/turf/open/floor/plating/airless,
/area/ruin/space/has_grav)
"HL" = (
/obj/structure/closet/crate,
/turf/open/floor/plating/airless,
/area/ruin/space/has_grav)
"HX" = (
/obj/item/trash/can/food/beans,
/turf/open/floor/plating,
/area/ruin/space/has_grav)
"Iz" = (
/obj/machinery/portable_atmospherics/scrubber,
/turf/open/floor/plating,
/area/ruin/space/has_grav)
"IN" = (
/mob/living/simple_animal/hostile/asteroid/basilisk,
/turf/open/floor/plating/airless,
/area/ruin/space/has_grav)
"Jf" = (
/turf/closed/mineral/random/high_chance,
/area/ruin/space/has_grav)
"Lk" = (
/obj/item/reagent_containers/food/drinks/waterbottle/large/empty,
/turf/open/floor/plating,
/area/ruin/space/has_grav)
"NO" = (
/obj/item/trash/energybar,
/turf/open/floor/plating,
/area/ruin/space/has_grav)
"Oi" = (
/obj/effect/mob_spawn/human/corpse/whitesands/survivor/hunter,
/turf/open/floor/plating/asteroid/airless,
/area/ruin/space/has_grav)
"OA" = (
/mob/living/simple_animal/hostile/whitesands/survivor,
/turf/open/floor/plating,
/area/ruin/space/has_grav)
"OO" = (
/turf/closed/wall/rust,
/area/ruin/space/has_grav)
"OY" = (
/obj/structure/barricade/sandbags,
/turf/open/floor/plating/asteroid/airless,
/area/ruin/space/has_grav)
"QC" = (
/obj/structure/table,
/turf/open/floor/plating,
/area/ruin/space/has_grav)
"Su" = (
/mob/living/simple_animal/hostile/asteroid/basilisk,
/turf/open/floor/plating/asteroid/airless,
/area/ruin/space/has_grav)
"VQ" = (
/obj/item/trash/pistachios,
/turf/open/floor/plating,
/area/ruin/space/has_grav)
"WB" = (
/obj/effect/mob_spawn/human/corpse/whitesands/survivor,
/turf/open/floor/plating/asteroid/airless,
/area/ruin/space/has_grav)
"Xb" = (
/obj/effect/mob_spawn/human/corpse/whitesands/survivor,
/obj/item/grenade,
/turf/open/floor/plating/asteroid/airless,
/area/ruin/space/has_grav)
"XC" = (
/obj/structure/barricade/wooden,
/turf/open/floor/plating,
/area/ruin/space/has_grav)

(1,1,1) = {"
aa
aa
aa
aa
aa
aa
aa
aa
aa
aa
aa
aa
aa
aa
aa
aa
aa
aa
aa
aa
aa
aa
aa
aa
aa
aa
aa
aa
aa
aa
aa
aa
aa
aa
aa
aa
aa
aa
aa
aa
aa
aa
aa
aa
aa
aa
aa
aa
aa
aa
aa
aa
aa
aa
aa
aa
aa
aa
aa
aa
"}
(2,1,1) = {"
aa
aa
aa
aa
aa
aa
aa
aa
aa
aa
aa
aa
aa
aa
aa
aa
aa
aa
aa
aa
aa
aa
aa
aa
aa
aa
aa
aa
aa
aa
aa
aa
aa
aa
aa
aa
aa
aa
aa
aa
aa
aa
aa
aa
aa
aa
aa
aa
aa
aa
aa
aa
aa
aa
aa
aa
aa
aa
aa
aa
"}
(3,1,1) = {"
aa
aa
aa
aa
aa
aa
aa
aa
aa
aa
aa
aa
aa
aa
aa
aa
aa
aa
aa
aa
aa
aa
aa
aa
aa
aa
aa
aa
aa
aa
aa
aa
aa
aa
aa
aa
aa
aa
aa
aa
aa
aa
aa
aa
aa
aa
aa
aa
aa
aa
aa
aa
aa
aa
aa
aa
aa
aa
aa
aa
"}
(4,1,1) = {"
aa
aa
aa
aa
aa
aa
aa
aa
aa
aa
aa
aa
aa
aa
aa
aa
aa
aa
aa
aa
aa
aa
aa
aa
aa
aa
aa
aa
aa
aa
aa
aa
aa
aa
aa
aa
aa
aa
aa
aa
aa
aa
aa
aa
aa
aa
aa
aa
aa
aa
aa
aa
aa
aa
aa
aa
aa
aa
aa
aa
"}
(5,1,1) = {"
aa
aa
aa
aa
aa
aa
aa
aa
aa
aa
aa
aa
aa
aa
aa
aa
aa
aa
aa
aa
aa
aa
aa
aa
aa
aa
aa
aa
aa
aa
aa
aa
aa
aa
aa
aa
aa
aa
aa
aa
aa
aa
aa
aa
aa
aa
aa
aa
aa
aa
aa
aa
aa
aa
aa
aa
aa
aa
aa
aa
"}
(6,1,1) = {"
aa
aa
aa
aa
aa
aa
aa
aa
aa
aa
aa
aa
aa
aa
aa
aa
aa
aa
aa
aa
aa
aa
aa
aa
aa
aa
aa
aa
aa
aa
aa
Av
aa
aa
aa
aa
aa
aa
aa
aa
aa
aa
aa
aa
aa
aa
aa
aa
aa
aa
aa
aa
aa
aa
aa
aa
aa
aa
aa
aa
"}
(7,1,1) = {"
aa
aa
aa
aa
aa
aa
aa
aa
aa
aa
aa
aa
aa
aa
aa
aa
aa
aa
aa
aa
aa
aa
aa
aa
aa
aa
aa
aa
aa
aa
aa
aa
aa
aa
aa
aa
aa
aa
aa
aa
aa
aa
aa
aa
aa
aa
aa
aa
aa
aa
aa
aa
aa
aa
aa
aa
aa
aa
aa
aa
"}
(8,1,1) = {"
aa
aa
aa
aa
aa
aa
aa
aa
aa
aa
aa
aa
aa
aa
aa
aa
aa
aa
aa
aa
aa
aa
aa
aa
aa
aa
aa
aa
aa
aa
aa
aa
aa
aa
aa
aa
aa
aa
aa
aa
aa
aa
aa
aa
aa
aa
aa
aa
aa
aa
aa
aa
aa
aa
aa
aa
aa
aa
aa
aa
"}
(9,1,1) = {"
aa
aa
aa
aa
aa
aa
aa
aa
aa
aa
aa
aa
aa
aa
aa
aa
aa
aa
aa
aa
aa
aa
aa
aa
aa
aa
aa
aa
aa
aa
aa
aa
aa
aa
aa
aa
aa
aa
aa
aa
aa
aa
aa
aa
aa
aa
aa
aa
aa
aa
aa
aa
Av
aa
aa
aa
aa
aa
aa
aa
"}
(10,1,1) = {"
aa
aa
aa
aa
aa
aa
aa
aa
aa
aa
tr
tr
tr
tr
tr
aa
aa
aa
aa
aa
aa
tr
tr
tr
aQ
tr
tr
tr
tr
tr
tr
tr
tr
tr
tr
tr
aa
tr
tr
tr
tr
tr
aa
aa
aa
aa
aa
aa
aa
aa
aa
aa
aa
aa
aa
aa
aa
aa
aa
aa
"}
(11,1,1) = {"
aa
aa
aa
aa
aa
aa
aa
aa
aa
aa
tr
tr
tr
tr
tr
tr
tr
aa
tr
tr
tr
tr
tr
tr
tr
tr
tr
tr
tr
aQ
tr
tr
tr
tr
tr
tr
aa
tr
tr
tr
tr
tr
tr
tr
aa
tr
aa
aa
aa
aa
aa
aa
aa
aa
aa
aa
aa
aa
aa
aa
"}
(12,1,1) = {"
aa
aa
aa
aa
aa
aa
aa
aa
aa
tr
tr
tr
tr
aQ
aQ
tr
tr
tr
tr
tr
tr
tr
aQ
aQ
tr
tr
tr
tr
tr
tr
tr
tr
tr
tr
tr
tr
ab
tr
tr
tr
tr
tr
tr
tr
tr
tr
tr
tr
aa
aa
aa
aa
aa
aa
aa
aa
aa
aa
aa
aa
"}
(13,1,1) = {"
aa
aa
aa
aa
aa
aa
aa
aa
tr
tr
tr
aQ
aQ
aQ
aQ
aQ
tr
tr
aQ
tr
tr
aQ
aQ
aQ
tr
aQ
aQ
aQ
aQ
aQ
aQ
aQ
aQ
aQ
aQ
aQ
ab
aQ
tr
aQ
aQ
aQ
tr
aQ
tr
tr
tr
tr
aa
aa
aa
aa
aa
aa
aa
aa
aa
aa
aa
aa
"}
(14,1,1) = {"
aa
aa
aa
aa
aa
aa
aa
aa
tr
tr
tr
aQ
aQ
aQ
aQ
tr
tr
tr
tr
tr
aQ
aQ
tr
aQ
aQ
aQ
aQ
aQ
aQ
aQ
aQ
aQ
aQ
aQ
aQ
aQ
ab
aQ
aQ
tr
aQ
tr
tr
aQ
tr
tr
tr
tr
tr
tr
aa
aa
aa
aa
aa
aa
aa
aa
aa
aa
"}
(15,1,1) = {"
aa
aa
aa
aa
aa
aa
aa
tr
tr
tr
tr
aQ
aQ
tr
tr
tr
tr
tr
tr
aQ
aQ
tr
au
au
au
au
au
au
au
au
au
au
au
au
au
ay
au
aQ
aQ
aQ
aQ
aQ
aQ
aQ
aQ
tr
tr
tr
tr
tr
aa
aa
aa
aa
aa
aa
aa
aa
aa
aa
"}
(16,1,1) = {"
aa
aa
aa
aa
aa
aa
aa
tr
tr
tr
tr
au
au
au
aQ
aQ
aQ
tr
aQ
aQ
aQ
aQ
au
au
aQ
aQ
au
au
au
aQ
aQ
aQ
au
aQ
au
aD
ae
au
au
au
OY
af
au
au
au
au
tr
tr
tr
tr
aa
aa
aa
aa
aa
aa
aa
aa
aa
aa
"}
(17,1,1) = {"
aa
aa
aa
aa
aa
aa
tr
tr
tr
tr
tr
aQ
aQ
au
au
aQ
tr
tr
aQ
aQ
aQ
au
au
au
aQ
aQ
au
au
aQ
aQ
aQ
aQ
aQ
aQ
aQ
aQ
ah
al
aC
WB
iT
at
au
ay
aD
au
tr
au
au
tr
aa
aa
aa
aa
aa
aa
aa
aa
aa
aa
"}
(18,1,1) = {"
aa
aa
aa
aa
aa
aa
tr
tr
tr
tr
tr
aQ
aQ
aQ
au
au
aQ
aQ
aQ
aQ
aQ
aQ
au
au
aQ
aQ
aQ
aQ
aQ
aQ
aQ
aQ
aQ
aQ
aQ
aQ
ap
aj
ag
au
OY
au
aK
ae
au
au
au
au
au
tr
aa
aa
aa
aa
aa
aa
aa
aa
aa
aa
"}
(19,1,1) = {"
aa
aa
aa
aa
aa
aa
tr
tr
tr
aQ
tr
aQ
au
au
aQ
au
au
aQ
aQ
aQ
aQ
au
au
au
aQ
aQ
aQ
aQ
aQ
aQ
aQ
aQ
aQ
aQ
aQ
aQ
aU
aS
aY
au
au
au
au
aQ
aQ
tr
tr
au
au
tr
tr
aa
aa
aa
aa
aa
aa
aa
aa
aa
"}
(20,1,1) = {"
aa
aa
Av
aa
aa
aa
tr
tr
tr
tr
tr
aQ
au
au
aQ
aQ
au
aQ
aQ
aQ
au
au
au
ae
aQ
aQ
aQ
Su
aQ
aQ
aQ
aQ
aQ
aQ
aQ
aQ
aQ
aQ
OO
tA
OO
FU
OO
OO
tA
tr
tr
aQ
au
tr
tr
tr
aa
aa
aa
aa
aa
aa
aa
aa
"}
(21,1,1) = {"
aa
aa
aa
aa
aa
aa
tr
aQ
tr
au
au
aQ
au
au
au
au
au
au
au
au
au
au
au
aQ
aQ
aQ
aQ
aQ
aQ
aQ
aQ
aQ
aQ
aQ
aQ
aQ
aQ
aQ
OO
yM
zP
xH
kT
kT
tA
dV
dV
dV
dV
tr
tr
tr
tr
aa
aa
aa
aa
aa
aa
aa
"}
(22,1,1) = {"
aa
aa
aa
aa
aa
tr
tr
tr
tr
au
au
aQ
au
au
au
au
au
au
au
au
aQ
aQ
aQ
aQ
aQ
aQ
aQ
aQ
aQ
aQ
aQ
aQ
aQ
aQ
aQ
aQ
aQ
aQ
tA
yM
yM
yM
Iz
ez
OO
dV
dV
dV
dV
IN
dV
tr
tr
tr
tA
aa
aa
aa
aa
aa
"}
(23,1,1) = {"
aa
aa
aa
aa
aa
tr
tr
tr
tr
au
au
au
au
aQ
aQ
aQ
aQ
aQ
aQ
aQ
aQ
aQ
aQ
aQ
aQ
aQ
aQ
tr
aQ
Jf
aQ
aQ
aQ
aQ
aQ
aQ
aQ
tr
OO
yM
yM
yM
BD
yM
lL
dV
dV
dV
dV
dV
HL
HL
dV
dV
tA
aa
aa
aa
aa
aa
"}
(24,1,1) = {"
aa
aa
aa
aa
tr
tr
tr
aQ
tr
au
au
au
au
aQ
aQ
aQ
aQ
aQ
aQ
aQ
aQ
tr
aQ
aQ
aQ
aQ
Jf
aQ
Jf
aQ
aQ
aQ
aQ
aQ
aQ
aQ
aQ
tr
OO
yM
yM
yM
yM
lu
tA
dV
dV
dV
dV
rF
dV
HL
dV
HL
tA
aa
aa
aa
aa
aa
"}
(25,1,1) = {"
aa
aa
aa
aa
tr
tr
tr
aQ
tr
au
aQ
aQ
aQ
aQ
aQ
aQ
aQ
aQ
aQ
aQ
aQ
aQ
aQ
aQ
aQ
aQ
Jf
Jf
Jf
Jf
aQ
aQ
aQ
aQ
Jf
aQ
tr
tr
OO
wK
yM
yM
yM
wo
OO
dV
dV
dV
dV
dV
dV
dV
dV
dV
tA
aa
aa
aa
aa
aa
"}
(26,1,1) = {"
aa
aa
aa
aa
aa
tr
tr
tr
tr
au
aQ
aQ
aQ
aQ
aQ
aQ
aQ
aQ
aQ
aQ
aQ
Jf
aQ
Jf
Jf
Jf
aQ
au
au
aQ
Jf
Jf
aQ
aQ
aQ
aQ
tr
tr
tA
tA
OO
ys
OO
OO
OO
aQ
tA
tA
tA
OO
OO
OO
lL
tA
tA
aa
aa
aa
aa
aa
"}
(27,1,1) = {"
aa
aa
aa
aa
aa
tr
tr
tr
Su
au
aQ
aQ
aQ
aQ
aQ
aQ
aQ
aQ
aQ
Jf
Jf
Jf
Jf
au
au
au
au
au
au
au
ae
au
au
aQ
aQ
aQ
tr
tr
QC
QC
yM
XC
XC
yM
yM
tr
tr
aa
aa
aa
aa
OO
dV
tA
aa
aa
aa
aa
aa
aa
"}
(28,1,1) = {"
aa
aa
aa
aa
tr
tr
aQ
tr
au
aQ
aQ
aQ
aQ
aQ
aQ
aQ
aQ
aQ
aQ
Jf
Jf
Jf
au
au
au
au
au
au
au
sN
au
aQ
aQ
aQ
aQ
aQ
tr
yM
ba
da
yM
HX
fd
OA
fd
tr
tr
aa
aa
aa
aa
OO
lL
tA
aa
aa
aa
aa
aa
aa
"}
(29,1,1) = {"
aa
aa
aa
aa
tr
tr
aQ
au
Xb
aQ
aQ
aQ
tr
Jf
Jf
Jf
aQ
aQ
Jf
Jf
Jf
au
Su
au
au
au
au
au
au
au
au
Jf
Jf
aQ
aQ
tr
ba
yM
yM
OA
Lk
yM
yM
yM
yM
tr
tr
aa
aa
aa
aa
aa
aa
Av
aa
aa
aa
aa
aa
aa
"}
(30,1,1) = {"
aa
aa
aa
aa
tr
aQ
tr
au
au
aQ
aQ
aQ
tr
aQ
aQ
aQ
aQ
aQ
aQ
aQ
Jf
au
au
au
au
au
au
au
au
au
au
aQ
aQ
aQ
aQ
tr
yM
yM
yM
yM
yM
yM
NO
yM
yM
tr
tr
aa
aa
aa
aa
aa
aa
aa
aa
aa
aa
aa
aa
aa
"}
(31,1,1) = {"
aa
aa
aa
aa
aQ
aQ
au
au
au
aQ
aQ
aQ
aQ
aQ
aQ
aQ
aQ
aQ
aQ
aQ
aQ
au
au
au
au
au
au
yP
au
au
au
au
aQ
aQ
aQ
tr
yM
yM
yM
Lk
NO
yM
hI
fd
yM
tr
tr
aa
aa
aa
Av
aa
aa
aa
aa
aa
aa
aa
aa
aa
"}
(32,1,1) = {"
aa
aa
aa
aa
aa
aa
sN
au
OY
aQ
aQ
aQ
Jf
aQ
aQ
Jf
aQ
Jf
Jf
aQ
aQ
au
au
au
au
au
au
au
au
au
au
au
au
aQ
aQ
tr
tr
tr
HX
yM
yM
yM
VQ
yM
tr
tr
aa
aa
aa
aa
aa
aa
aa
aa
aa
aa
aa
aa
aa
aa
"}
(33,1,1) = {"
aa
aa
aa
aa
aa
aa
au
Oi
OY
au
aQ
aQ
aQ
aQ
aQ
Jf
aQ
aQ
Jf
Jf
aQ
aQ
aQ
aQ
au
au
au
au
au
au
aQ
au
wT
au
aQ
tr
tr
yM
yM
yM
yM
ba
yM
ba
tr
tr
aa
aa
aa
aa
aa
aa
aa
aa
aa
aa
aa
aa
aa
aa
"}
(34,1,1) = {"
aa
aa
aa
aa
Av
aa
tr
tr
tr
au
aQ
aQ
aQ
tr
aQ
aQ
aQ
aQ
aQ
aQ
aQ
aQ
aQ
Jf
Jf
Jf
sN
au
Jf
Jf
Jf
aQ
au
WB
aQ
aQ
tr
tr
tr
tr
tr
tr
yM
yM
tr
tr
aa
aa
aa
aa
aa
aa
aa
aa
aa
aa
aa
aa
aa
aa
"}
(35,1,1) = {"
aa
aa
aa
aa
aa
aQ
tr
tr
tr
au
au
au
aQ
tr
aQ
aQ
Jf
aQ
aQ
Jf
aQ
tr
aQ
Jf
aQ
Jf
au
au
Jf
Jf
Jf
aQ
aQ
au
aQ
aQ
aQ
tr
tr
tr
tr
tr
tr
tr
tr
tr
aa
aa
aa
aa
aa
aa
aa
aa
aa
aa
aa
aa
aa
aa
"}
(36,1,1) = {"
aa
aa
aa
aa
tr
tr
tr
tr
tr
tr
au
au
au
aQ
aQ
aQ
aQ
aQ
aQ
aQ
aQ
aQ
aQ
aQ
aQ
Jf
Jf
Jf
Jf
aQ
aQ
aQ
aQ
au
Jf
aQ
aQ
aQ
aQ
aQ
tr
tr
tr
tr
tr
tr
tr
aa
aa
aa
aa
aa
aa
aa
aa
aa
aa
aa
aa
aa
"}
(37,1,1) = {"
aa
aa
aa
aa
tr
tr
tr
aQ
tr
tr
au
au
au
aQ
aQ
aQ
aQ
aQ
aQ
aQ
aQ
aQ
aQ
aQ
aQ
aQ
aQ
aQ
aQ
aQ
aQ
aQ
aQ
au
au
aQ
aQ
aQ
aQ
aQ
tr
tr
tr
tr
tr
tr
tr
aa
aa
aa
aa
aa
aa
aa
aa
aa
aa
aa
aa
aa
"}
(38,1,1) = {"
aa
aa
aa
aa
tr
tr
tr
aQ
aQ
tr
aQ
au
ae
au
aQ
aQ
aQ
aQ
aQ
aQ
aQ
aQ
aQ
aQ
aQ
aQ
aQ
aQ
aQ
aQ
ae
aQ
Jf
Jf
au
aQ
Jf
aQ
aQ
aQ
aQ
aQ
tr
tr
tr
tr
tr
aa
aa
aa
aa
aa
aa
aa
aa
aa
aa
aa
aa
aa
"}
(39,1,1) = {"
aa
aa
aa
aa
tr
tr
tr
tr
aQ
tr
aQ
aQ
au
au
aQ
aQ
au
au
aQ
aQ
aQ
aQ
aQ
tr
aQ
aQ
aQ
aQ
aQ
aQ
aQ
aQ
aQ
aQ
au
aQ
aQ
aQ
aQ
aQ
aQ
tr
tr
tr
tr
tr
tr
aa
aa
aa
aa
aa
aa
aa
aa
aa
aa
aa
aa
aa
"}
(40,1,1) = {"
aa
aa
aa
aa
aQ
aQ
tr
tr
aQ
tr
aQ
aQ
aQ
au
aQ
aQ
au
au
au
aQ
aQ
aQ
aQ
aQ
aQ
aQ
aQ
aQ
aQ
aQ
aQ
aQ
aQ
aQ
au
aQ
aQ
aQ
aQ
aQ
aQ
tr
tr
tr
tr
aa
aa
aa
aa
aa
aa
aa
aa
aa
aa
aa
aa
aa
aa
aa
"}
(41,1,1) = {"
aa
aa
aa
aa
aa
aQ
tr
tr
tr
tr
tr
aQ
aQ
au
au
au
au
au
au
au
au
au
aQ
aQ
aQ
aQ
aQ
tr
aQ
aQ
aQ
aQ
aQ
aQ
au
au
aQ
aQ
aQ
aQ
aQ
aQ
tr
tr
tr
aa
aa
aa
aa
aa
aa
aa
aa
aa
aa
aa
aa
aa
aa
aa
"}
(42,1,1) = {"
aa
aa
aa
aa
aQ
aQ
tr
tr
tr
tr
tr
aQ
aQ
aQ
au
au
au
au
tr
tr
au
au
au
aQ
aQ
aQ
aQ
aQ
aQ
aQ
aQ
tr
aQ
aQ
au
Su
aQ
aQ
aQ
aQ
aQ
aQ
tr
tr
tr
aa
aa
aa
aa
aa
aa
aa
aa
aa
aa
aa
aa
aa
aa
aa
"}
(43,1,1) = {"
aa
aa
aa
aa
aa
aQ
tr
tr
tr
aQ
aQ
tr
tr
aQ
au
au
tr
tr
tr
tr
au
aQ
au
au
au
aQ
aQ
aQ
aQ
aQ
aQ
aQ
aQ
au
Oi
aQ
aQ
aQ
aQ
aQ
aQ
aQ
tr
tr
tr
aa
aa
aa
aa
aa
aa
aa
aa
aa
aa
aa
aa
aa
aa
aa
"}
(44,1,1) = {"
aa
aa
aa
aa
aa
aa
aa
tr
tr
tr
tr
tr
tr
aQ
tr
tr
tr
aQ
aQ
tr
au
aQ
aQ
aQ
au
au
au
au
aQ
aQ
aQ
aQ
aQ
au
au
aQ
aQ
aQ
aQ
aQ
tr
tr
tr
tr
tr
aa
aa
aa
aa
aa
aa
aa
aa
aa
aa
aa
aa
aa
aa
aa
"}
(45,1,1) = {"
aa
aa
aa
aa
aa
aa
aa
tr
tr
tr
tr
tr
tr
aQ
tr
aQ
aQ
aQ
aQ
tr
tr
aQ
aQ
aQ
aQ
aQ
aQ
aQ
au
au
au
au
au
au
aQ
aQ
aQ
aQ
aQ
tr
tr
tr
tr
tr
aa
aa
aa
aa
aa
aa
aa
aa
aa
aa
aa
aa
aa
aa
aa
aa
"}
(46,1,1) = {"
aa
aa
aa
aa
aa
aa
aa
tr
tr
tr
tr
tr
tr
tr
tr
tr
tr
tr
aQ
aQ
tr
tr
aQ
aQ
aQ
aQ
tr
aQ
aQ
aQ
aQ
aQ
aQ
aQ
tr
tr
aQ
aQ
aQ
tr
tr
tr
tr
tr
aa
aa
aa
aa
Av
aa
aa
aa
aa
aa
aa
aa
aa
aa
aa
aa
"}
(47,1,1) = {"
aa
aa
aa
aa
aa
aa
aa
aa
aQ
tr
tr
aQ
tr
tr
tr
tr
tr
tr
tr
aQ
tr
tr
tr
tr
aQ
aQ
aQ
aQ
aQ
aQ
aQ
aQ
aQ
aQ
tr
aQ
tr
tr
tr
tr
tr
tr
tr
aa
aa
aa
aa
aa
aa
aa
aa
aa
aa
aa
aa
aa
aa
Av
aa
aa
"}
(48,1,1) = {"
Av
aa
aa
aa
aa
aa
aa
aa
aQ
tr
tr
aQ
tr
tr
aQ
tr
tr
tr
aQ
tr
tr
tr
aQ
aQ
tr
tr
aQ
aQ
tr
tr
aQ
aQ
aQ
tr
aQ
aQ
tr
tr
tr
tr
tr
tr
aa
aa
aa
aa
aa
aa
aa
aa
aa
aa
aa
aa
aa
aa
aa
aa
aa
aa
"}
(49,1,1) = {"
aa
aa
aa
aa
aa
aa
aa
aa
aa
aa
aa
aQ
aQ
tr
aQ
aQ
tr
tr
tr
tr
aQ
tr
tr
tr
tr
tr
tr
tr
tr
tr
tr
aQ
aQ
tr
aQ
aa
aa
aa
aa
aa
aa
aa
aa
aa
aa
aa
aa
aa
aa
aa
aa
aa
aa
aa
aa
aa
aa
aa
aa
aa
"}
(50,1,1) = {"
aa
aa
aa
aa
aa
aa
aa
aa
aa
aa
aa
tr
tr
tr
aQ
aQ
tr
tr
tr
tr
tr
tr
tr
aQ
tr
aa
tr
tr
tr
tr
tr
tr
aQ
aQ
aQ
aQ
aa
aa
aa
aa
aa
Av
aa
aa
aa
aa
aa
aa
aa
aa
aa
aa
aa
aa
aa
aa
aa
aa
aa
aa
"}
(51,1,1) = {"
aa
aa
aa
aa
aa
aa
aa
aa
aa
aa
aa
aa
tr
tr
tr
tr
tr
aQ
aQ
aQ
tr
aa
aQ
tr
tr
aa
aa
aa
aa
aa
tr
aa
aQ
aQ
aQ
aQ
aa
aa
aa
aa
aa
aa
aa
aa
aa
aa
aa
aa
aa
aa
aa
aa
aa
aa
aa
aa
aa
aa
aa
aa
"}
(52,1,1) = {"
aa
aa
aa
aa
aa
aa
aa
aa
aa
aa
aa
aa
aa
tr
tr
aQ
tr
tr
tr
aa
aa
aa
aa
aa
aa
aa
aa
aa
aa
aa
tr
aa
aa
aa
aa
aa
aa
aa
aa
aa
aa
aa
aa
aa
aa
aa
aa
aa
aa
aa
aa
aa
aa
aa
aa
aa
aa
aa
aa
aa
"}
(53,1,1) = {"
aa
aa
aa
aa
aa
aa
aa
aa
aa
aa
aa
aa
aa
tr
tr
tr
tr
tr
aa
aa
aa
aa
aa
aa
aa
aa
aa
aa
aa
aa
aa
aa
aa
aa
aa
aa
aa
aa
aa
aa
aa
aa
aa
aa
aa
aa
aa
aa
aa
aa
aa
aa
aa
aa
aa
aa
aa
aa
aa
aa
"}
(54,1,1) = {"
aa
aa
aa
aa
aa
aa
aa
aa
aa
aa
aa
aa
aa
aa
aa
aa
aa
aa
aa
aa
aa
aa
aa
Av
aa
aa
aa
aa
aa
aa
aa
aa
aa
aa
aa
aa
aa
aa
aa
aa
aa
aa
aa
aa
aa
aa
aa
aa
aa
aa
aa
aa
aa
aa
aa
aa
aa
aa
aa
aa
"}
(55,1,1) = {"
aa
aa
aa
aa
aa
aa
aa
aa
aa
aa
aa
aa
aa
aa
aa
aa
aa
aa
aa
aa
aa
aa
aa
aa
aa
aa
aa
aa
aa
aa
aa
aa
aa
aa
aa
aa
aa
aa
aa
aa
aa
aa
aa
aa
aa
aa
aa
aa
aa
aa
aa
aa
aa
aa
aa
aa
aa
aa
aa
aa
"}
(56,1,1) = {"
aa
aa
aa
aa
aa
aa
aa
aa
aa
Av
aa
aa
aa
aa
aa
aa
aa
tr
tr
tr
aa
aa
aa
aa
aa
aa
aa
aa
aa
aa
aa
aa
aa
aa
aa
aa
aa
aa
aa
aa
aa
aa
aa
aa
aa
aa
aa
aa
aa
aa
aa
aa
aa
aa
aa
aa
aa
aa
aa
aa
"}
(57,1,1) = {"
aa
aa
aa
aa
aa
aa
aa
aa
aa
aa
aa
aa
aa
aa
aa
aa
aa
aa
aa
aa
aa
aa
aa
aa
aa
aa
aa
aa
aa
aa
aa
aa
aa
aa
aa
aa
aa
aa
aa
aa
aa
aa
aa
aa
aa
aa
aa
aa
aa
aa
aa
aa
aa
aa
aa
aa
aa
aa
aa
aa
"}
(58,1,1) = {"
aa
aa
aa
aa
aa
aa
aa
aa
aa
aa
aa
aa
aa
aa
aa
aa
aa
aa
aa
aa
aa
aa
aa
aa
aa
aa
aa
aa
aa
aa
aa
aa
aa
aa
aa
aa
aa
aa
aa
aa
aa
aa
aa
aa
aa
aa
aa
aa
aa
aa
aa
aa
aa
aa
aa
aa
aa
aa
aa
aa
"}
(59,1,1) = {"
aa
aa
aa
aa
aa
aa
aa
aa
aa
aa
aa
aa
aa
aa
aa
aa
aa
aa
aa
aa
aa
aa
aa
aa
aa
aa
aa
aa
aa
aa
aa
aa
aa
aa
aa
aa
aa
aa
aa
aa
aa
aa
aa
aa
aa
aa
aa
aa
aa
aa
aa
aa
aa
aa
aa
aa
aa
aa
aa
aa
"}
(60,1,1) = {"
aa
aa
aa
aa
aa
aa
aa
aa
aa
aa
aa
aa
aa
aa
aa
aa
aa
aa
aa
aa
aa
aa
aa
aa
aa
aa
aa
aa
aa
aa
aa
aa
aa
aa
aa
aa
aa
aa
aa
aa
aa
aa
aa
aa
aa
aa
aa
aa
aa
aa
aa
aa
aa
aa
aa
aa
aa
aa
aa
aa
"}
