//MAP CONVERTED BY dmm2tgm.py THIS HEADER COMMENT PREVENTS RECONVERSION, DO NOT REMOVE
"aa" = (
/turf/open/space/basic,
/area/space)
"ab" = (
/turf/closed/mineral,
/area/ruin/space/has_grav)
"ae" = (
/mob/living/simple_animal/hostile/asteroid/hivelord,
/turf/open/floor/plating/asteroid/airless,
/area/ruin/space/has_grav)
"af" = (
/obj/item/stack/medical/bruise_pack,
/turf/open/floor/plating/asteroid/airless,
/area/ruin/space/has_grav)
"ag" = (
/obj/item/stack/ore/gold{
	amount = 2;
	pixel_x = 13
	},
/turf/open/floor/plating/asteroid/airless,
/area/ruin/space/has_grav)
"al" = (
/obj/item/stack/ore/titanium,
/turf/open/floor/plating/asteroid/airless,
/area/ruin/space/has_grav)
"au" = (
/turf/open/floor/plating/asteroid/airless,
/area/ruin/space/has_grav)
"ay" = (
/obj/item/mining_scanner,
/turf/open/floor/plating/asteroid/airless,
/area/ruin/space/has_grav)
"aC" = (
/obj/item/stack/ore/gold{
	amount = 2;
	pixel_x = 13;
	pixel_y = 10
	},
/turf/open/floor/plating/asteroid/airless,
/area/ruin/space/has_grav)
"aD" = (
/obj/item/pickaxe/drill,
/turf/open/floor/plating/asteroid/airless,
/area/ruin/space/has_grav)
"aQ" = (
/turf/closed/mineral/random,
/area/ruin/space/has_grav)
"aU" = (
/obj/item/stack/ore/plasma{
	amount = 10;
	pixel_x = -10;
	pixel_y = -10
	},
/turf/open/floor/plating/asteroid/airless,
/area/ruin/space/has_grav)
"cf" = (
/obj/item/stack/ore/plasma{
	amount = 5;
	pixel_x = -15;
	pixel_y = -10
	},
/turf/open/floor/plating/asteroid/airless,
/area/ruin/space/has_grav)
"dq" = (
/obj/structure/flora/ash/space/voidmelon,
/turf/open/floor/plating/asteroid/airless,
/area/ruin/space/has_grav)
"eY" = (
/obj/structure/barricade/sandbags,
/turf/open/floor/plating/asteroid/airless,
/area/ruin/space/has_grav)
"gy" = (
/mob/living/simple_animal/hostile/asteroid/basilisk,
/turf/open/floor/plating/airless,
/area/ruin/space/has_grav)
"gW" = (
/mob/living/simple_animal/hostile/asteroid/goliath/beast/ancient,
/turf/open/floor/plating/asteroid/airless,
/area/ruin/space/has_grav)
"hx" = (
/obj/item/stack/ore/silver{
	amount = 2;
	pixel_x = -16;
	pixel_y = -4
	},
/turf/open/floor/plating/asteroid/airless,
/area/ruin/space/has_grav)
"hz" = (
/obj/machinery/portable_atmospherics/pump,
/turf/open/floor/plating,
/area/ruin/space/has_grav)
"iw" = (
/obj/item/trash/energybar,
/turf/open/floor/plating,
/area/ruin/space/has_grav)
"jD" = (
/turf/closed/wall/rust,
/area/ruin/space/has_grav)
"nf" = (
/obj/item/stack/ore/diamond{
	pixel_x = 5;
	pixel_y = 10
	},
/turf/open/floor/plating/asteroid/airless,
/area/ruin/space/has_grav)
"oo" = (
/obj/structure/table,
/turf/open/floor/plating,
/area/ruin/space/has_grav)
"oy" = (
/obj/structure/closet/crate,
/turf/open/floor/plating,
/area/ruin/space/has_grav)
"oN" = (
/obj/machinery/portable_atmospherics/canister/air,
/turf/open/floor/plating,
/area/ruin/space/has_grav)
"pi" = (
/obj/effect/mob_spawn/human/corpse/whitesands/survivor,
/obj/item/grenade,
/turf/open/floor/plating/asteroid/airless,
/area/ruin/space/has_grav)
"ry" = (
/turf/closed/mineral/random/high_chance,
/area/ruin/space/has_grav)
"tG" = (
/obj/item/stack/ore/silver{
	amount = 5;
	pixel_x = 6;
	pixel_y = 5
	},
/turf/open/floor/plating/asteroid/airless,
/area/ruin/space/has_grav)
"uZ" = (
/turf/closed/wall/material,
/area/ruin/space/has_grav)
"wJ" = (
/obj/item/stack/ore/iron{
	amount = 5;
	pixel_x = -10;
	pixel_y = 3
	},
/turf/open/floor/plating/asteroid/airless,
/area/ruin/space/has_grav)
"yq" = (
/obj/item/stack/ore/silver{
	amount = 5;
	pixel_x = 7;
	pixel_y = -3
	},
/turf/open/floor/plating/asteroid/airless,
/area/ruin/space/has_grav)
"yw" = (
/obj/effect/decal/cleanable/blood,
/turf/open/floor/plating/asteroid/airless,
/area/ruin/space/has_grav)
"At" = (
/obj/item/reagent_containers/food/drinks/waterbottle/large/empty,
/turf/open/floor/plating,
/area/ruin/space/has_grav)
"AR" = (
/mob/living/simple_animal/hostile/whitesands/ranged/hunter,
/turf/open/floor/plating,
/area/ruin/space/has_grav)
"Bp" = (
/obj/effect/decal/cleanable/oil/streak,
/turf/open/floor/plating,
/area/ruin/space/has_grav)
"BZ" = (
/obj/effect/decal/cleanable/oil,
/obj/machinery/door/airlock/hatch,
/turf/open/floor/plating/airless,
/area/ruin/space/has_grav)
"CF" = (
/obj/structure/closet/crate,
/turf/open/floor/plating/airless,
/area/ruin/space/has_grav)
"DL" = (
/obj/item/stack/ore/uranium{
	pixel_x = -10
	},
/turf/open/floor/plating/asteroid/airless,
/area/ruin/space/has_grav)
"Ee" = (
/obj/item/stack/medical/bruise_pack,
/turf/open/floor/plating/airless,
/area/ruin/space/has_grav)
"EB" = (
/obj/item/stack/sheet/glass/fifty,
/turf/open/floor/plating,
/area/ruin/space/has_grav)
"FC" = (
/obj/machinery/portable_atmospherics/scrubber,
/turf/open/floor/plating,
/area/ruin/space/has_grav)
"Hb" = (
/obj/item/radio/off,
/turf/open/floor/plating,
/area/ruin/space/has_grav)
"Hd" = (
/obj/structure/barricade/wooden,
/turf/open/floor/plating,
/area/ruin/space/has_grav)
"Ht" = (
/turf/open/floor/plating,
/area/ruin/space/has_grav)
"Ii" = (
/obj/structure/bed,
/turf/open/floor/plating,
/area/ruin/space/has_grav)
"Is" = (
/obj/machinery/door/airlock/hatch,
/obj/structure/barricade/wooden,
/turf/open/floor/plating/airless,
/area/ruin/space/has_grav)
"IN" = (
/obj/item/trash/boritos,
/turf/open/floor/plating,
/area/ruin/space/has_grav)
"KC" = (
/mob/living/simple_animal/hostile/asteroid/basilisk,
/turf/open/floor/plating/asteroid/airless,
/area/ruin/space/has_grav)
"KM" = (
/obj/effect/mob_spawn/human/corpse/cargo_tech,
/turf/open/floor/plating/airless,
/area/ruin/space/has_grav)
"La" = (
/obj/machinery/power/port_gen/pacman,
/turf/open/floor/plating,
/area/ruin/space/has_grav)
"Lp" = (
/obj/item/stack/medical/ointment,
/obj/item/ammo_casing/ballistic/aac_300blk/recycled,
/turf/open/floor/plating/asteroid/airless,
/area/ruin/space/has_grav)
"Mr" = (
/obj/item/tank/internals/oxygen,
/obj/item/tank/internals/oxygen,
/obj/item/tank/jetpack/improvised,
/turf/open/floor/plating,
/area/ruin/space/has_grav)
"NR" = (
/obj/item/trash/pistachios,
/turf/open/floor/plating,
/area/ruin/space/has_grav)
"Ow" = (
/obj/item/ammo_casing/ballistic/aac_300blk/recycled,
/turf/open/floor/plating/asteroid/airless,
/area/ruin/space/has_grav)
"Pc" = (
/obj/machinery/door/airlock/hatch,
/turf/open/floor/plating/airless,
/area/ruin/space/has_grav)
"Pi" = (
/turf/closed/mineral/random/labormineral,
/area/ruin/space/has_grav)
"QK" = (
/mob/living/simple_animal/hostile/carp,
/turf/open/space/basic,
/area/space)
"QP" = (
/obj/effect/mob_spawn/human/corpse/whitesands/survivor,
/turf/open/floor/plating/asteroid/airless,
/area/ruin/space/has_grav)
"QU" = (
/mob/living/simple_animal/hostile/whitesands/survivor,
/turf/open/floor/plating,
/area/ruin/space/has_grav)
"Ru" = (
/obj/item/ammo_casing/ballistic/aac_300blk/recycled,
/obj/item/ammo_casing/ballistic/aac_300blk/recycled,
/turf/open/floor/plating/asteroid/airless,
/area/ruin/space/has_grav)
"RJ" = (
/obj/item/stack/ore/iron{
	amount = 15;
	pixel_x = 15;
	pixel_y = 5
	},
/turf/open/floor/plating/asteroid/airless,
/area/ruin/space/has_grav)
"RZ" = (
/obj/machinery/portable_atmospherics/canister/oxygen,
/turf/open/floor/plating,
/area/ruin/space/has_grav)
"Sd" = (
/obj/item/trash/can/food/beans,
/turf/open/floor/plating,
/area/ruin/space/has_grav)
"Sh" = (
/turf/open/floor/plating/airless,
/area/ruin/space/has_grav)
"Ug" = (
/obj/item/stack/ore/bluespace_crystal{
	pixel_x = -5;
	pixel_y = 10
	},
/turf/open/floor/plating/asteroid/airless,
/area/ruin/space/has_grav)
"Yt" = (
/obj/item/stack/ore/iron{
	amount = 15;
	pixel_x = -10;
	pixel_y = -4
	},
/turf/open/floor/plating/asteroid/airless,
/area/ruin/space/has_grav)
"ZC" = (
/obj/item/stack/ore/titanium{
	amount = 10;
	pixel_x = 5;
	pixel_y = -2
	},
/turf/open/floor/plating/asteroid/airless,
/area/ruin/space/has_grav)

(1,1,1) = {"
aa
aa
aa
aa
aa
aa
aa
aa
aa
aa
aa
aa
aa
aa
aa
aa
aa
aa
aa
aa
aa
aa
aa
aa
aa
aa
aa
aa
aa
aa
aa
aa
aa
aa
aa
aa
aa
aa
aa
aa
aa
aa
aa
aa
aa
aa
aa
aa
aa
aa
aa
aa
aa
aa
aa
aa
aa
aa
aa
aa
"}
(2,1,1) = {"
aa
aa
aa
aa
aa
aa
aa
aa
aa
aa
aa
aa
aa
aa
aa
aa
aa
aa
aa
aa
aa
aa
aa
aa
aa
aa
aa
aa
aa
aa
aa
aa
aa
aa
aa
aa
aa
aa
aa
aa
aa
aa
aa
aa
aa
aa
aa
aa
aa
aa
aa
aa
aa
aa
aa
aa
aa
aa
aa
aa
"}
(3,1,1) = {"
aa
aa
aa
aa
aa
aa
aa
aa
aa
aa
aa
aa
aa
aa
aa
aa
aa
aa
aa
aa
aa
aa
aa
aa
aa
aa
aa
aa
aa
aa
aa
aa
aa
aa
aa
aa
aa
aa
aa
aa
aa
aa
aa
aa
aa
aa
aa
aa
aa
aa
aa
aa
aa
aa
aa
aa
aa
aa
aa
aa
"}
(4,1,1) = {"
aa
aa
aa
aa
aa
aa
aa
aa
aa
aa
aa
aa
aa
aa
aa
aa
aa
aa
aa
aa
aa
aa
aa
aa
aa
aa
aa
aa
aa
aa
aa
aa
aa
aa
aa
aa
aa
aa
aa
aa
aa
aa
aa
aa
aa
aa
aa
aa
aa
aa
aa
aa
aa
aa
aa
aa
aa
aa
aa
aa
"}
(5,1,1) = {"
aa
aa
aa
aa
aa
aa
aa
aa
aa
aa
aa
aa
aa
aa
aa
aa
aa
aa
aa
aa
aa
aa
aa
aa
aa
aa
aa
aa
aa
aa
aa
aa
aa
aa
aa
aa
aa
aa
aa
aa
aa
aa
aa
aa
aa
aa
aa
aa
aa
aa
aa
aa
aa
aa
aa
aa
aa
aa
aa
aa
"}
(6,1,1) = {"
aa
aa
aa
aa
aa
aa
aa
aa
aa
aa
aa
aa
aa
aa
aa
aa
aa
aa
aa
aa
aa
aa
aa
aa
aa
aa
aa
aa
aa
aa
aa
QK
aa
aa
aa
aa
aa
aa
aa
aa
aa
aa
aa
aa
aa
aa
aa
aa
aa
aa
aa
aa
aa
aa
aa
aa
aa
aa
aa
aa
"}
(7,1,1) = {"
aa
aa
aa
aa
aa
aa
aa
aa
aa
aa
aa
aa
aa
aa
aa
aa
aa
aa
aa
aa
aa
aa
aa
aa
aa
aa
aa
aa
aa
aa
aa
aa
aa
aa
aa
aa
aa
aa
aa
aa
aa
aa
aa
aa
aa
aa
aa
aa
aa
aa
aa
aa
aa
aa
aa
aa
aa
aa
aa
aa
"}
(8,1,1) = {"
aa
aa
aa
aa
aa
aa
aa
aa
aa
aa
aa
aa
aa
aa
aa
aa
aa
aa
aa
aa
aa
aa
aa
aa
aa
aa
aa
aa
aa
aa
aa
aa
aa
aa
aa
aa
aa
aa
aa
aa
aa
aa
aa
aa
aa
aa
aa
aa
aa
aa
aa
aa
aa
aa
aa
aa
aa
aa
aa
aa
"}
(9,1,1) = {"
aa
aa
aa
aa
aa
aa
aa
aa
aa
aa
aa
aa
aa
aa
aa
aa
aa
aa
aa
aa
aa
aa
aa
aa
aa
aa
aa
aa
aa
aa
aa
aa
aa
aa
aa
aa
aa
aa
aa
aa
aa
aa
aa
aa
aa
aa
aa
aa
aa
aa
aa
aa
QK
aa
aa
aa
aa
aa
aa
aa
"}
(10,1,1) = {"
aa
aa
aa
aa
aa
aa
aa
aa
aa
aa
Pi
Pi
Pi
Pi
Pi
aa
aa
aa
aa
aa
aa
Pi
Pi
Pi
aQ
Pi
Pi
Pi
Pi
Pi
Pi
Pi
Pi
Pi
Pi
Pi
aa
Pi
Pi
Pi
Pi
Pi
aa
aa
aa
aa
aa
aa
aa
aa
aa
aa
aa
aa
aa
aa
aa
aa
aa
aa
"}
(11,1,1) = {"
aa
aa
aa
aa
aa
aa
aa
aa
aa
aa
Pi
Pi
Pi
Pi
Pi
Pi
Pi
aa
Pi
Pi
Pi
Pi
Pi
Pi
Pi
Pi
Pi
Pi
Pi
aQ
Pi
Pi
Pi
Pi
Pi
Pi
aa
Pi
Pi
Pi
Pi
Pi
Pi
Pi
aa
Pi
aa
aa
aa
aa
aa
aa
aa
aa
aa
aa
aa
aa
aa
aa
"}
(12,1,1) = {"
aa
aa
aa
aa
aa
aa
aa
aa
aa
Pi
Pi
Pi
Pi
aQ
aQ
Pi
Pi
Pi
Pi
Pi
Pi
Pi
aQ
aQ
Pi
Pi
Pi
Pi
Pi
Pi
Pi
Pi
Pi
Pi
Pi
Pi
ab
Pi
Pi
Pi
Pi
Pi
Pi
Pi
Pi
Pi
Pi
Pi
aa
aa
aa
aa
aa
aa
aa
aa
aa
aa
aa
aa
"}
(13,1,1) = {"
aa
aa
aa
aa
aa
aa
aa
aa
Pi
Pi
Pi
aQ
aQ
aQ
aQ
aQ
Pi
Pi
aQ
Pi
Pi
aQ
aQ
aQ
Pi
aQ
aQ
aQ
aQ
aQ
aQ
aQ
aQ
aQ
aQ
aQ
ab
aQ
Pi
aQ
aQ
aQ
Pi
aQ
Pi
Pi
Pi
Pi
aa
aa
aa
aa
aa
aa
aa
aa
aa
aa
aa
aa
"}
(14,1,1) = {"
aa
aa
aa
aa
aa
aa
aa
aa
Pi
Pi
Pi
aQ
aQ
aQ
aQ
Pi
Pi
Pi
Pi
Pi
aQ
aQ
Pi
aQ
aQ
aQ
aQ
aQ
aQ
aQ
aQ
aQ
aQ
aQ
aQ
aQ
ab
aQ
aQ
Pi
aQ
Pi
Pi
aQ
Pi
Pi
Pi
Pi
Pi
Pi
aa
aa
aa
aa
aa
aa
aa
aa
aa
aa
"}
(15,1,1) = {"
aa
aa
aa
aa
aa
aa
aa
Pi
Pi
Pi
Pi
aQ
aQ
Pi
Pi
Pi
Pi
Pi
Pi
aQ
aQ
Pi
au
au
au
au
au
au
yw
au
au
au
au
au
au
au
au
aQ
aQ
aQ
aQ
aQ
aQ
aQ
aQ
Pi
Pi
Pi
Pi
Pi
aa
aa
aa
aa
aa
aa
aa
aa
aa
aa
"}
(16,1,1) = {"
aa
aa
aa
aa
aa
aa
aa
Pi
Pi
Pi
Pi
au
au
au
aQ
aQ
aQ
Pi
aQ
aQ
aQ
aQ
au
au
aQ
aQ
yw
au
au
aQ
aQ
aQ
au
aQ
au
au
ae
Ow
au
au
eY
af
au
au
au
au
Pi
Pi
Pi
Pi
aa
aa
aa
aa
aa
aa
aa
aa
aa
aa
"}
(17,1,1) = {"
aa
aa
aa
aa
aa
aa
Pi
Pi
Pi
Pi
Pi
aQ
aQ
au
au
aQ
Pi
Pi
aQ
aQ
aQ
au
ay
au
aQ
aQ
au
au
aQ
aQ
aQ
aQ
aQ
aQ
aQ
aQ
au
au
au
au
eY
Lp
au
Ow
aD
au
Pi
au
au
Pi
aa
aa
aa
aa
aa
aa
aa
aa
aa
aa
"}
(18,1,1) = {"
aa
aa
aa
aa
aa
aa
Pi
Pi
Pi
Pi
Pi
aQ
aQ
aQ
au
au
aQ
aQ
aQ
aQ
aQ
aQ
au
au
aQ
aQ
aQ
aQ
aQ
aQ
aQ
aQ
aQ
aQ
aQ
aQ
tG
au
au
au
eY
Ow
au
ae
au
au
au
au
au
Pi
aa
aa
aa
aa
aa
aa
aa
aa
aa
aa
"}
(19,1,1) = {"
aa
aa
aa
aa
aa
aa
Pi
Pi
Pi
aQ
Pi
aQ
au
au
aQ
au
au
aQ
aQ
aQ
aQ
au
au
au
aQ
aQ
aQ
aQ
aQ
aQ
aQ
aQ
aQ
aQ
aQ
aQ
au
au
au
au
au
au
au
aQ
aQ
Pi
Pi
au
au
Pi
Pi
aa
aa
aa
aa
aa
aa
aa
aa
aa
"}
(20,1,1) = {"
aa
aa
QK
aa
aa
aa
Pi
Pi
Pi
Pi
Pi
aQ
au
au
aQ
aQ
au
aQ
aQ
aQ
au
au
au
ae
aQ
aQ
aQ
KC
aQ
aQ
aQ
aQ
aQ
aQ
aQ
aQ
aQ
aQ
jD
uZ
jD
BZ
jD
jD
uZ
Pi
Pi
aQ
au
Pi
Pi
Pi
aa
aa
aa
aa
aa
aa
aa
aa
"}
(21,1,1) = {"
aa
aa
aa
aa
aa
aa
Pi
aQ
Pi
au
au
aQ
au
au
au
au
au
au
au
au
au
au
au
aQ
aQ
aQ
aQ
aQ
aQ
aQ
aQ
aQ
aQ
aQ
aQ
aQ
aQ
aQ
jD
Ht
EB
Bp
oN
oN
uZ
Sh
Sh
Sh
Sh
Pi
Pi
Pi
Pi
aa
aa
aa
aa
aa
aa
aa
"}
(22,1,1) = {"
aa
aa
aa
aa
aa
Pi
Pi
Pi
Pi
au
au
aQ
au
au
au
au
au
au
au
au
aQ
aQ
aQ
aQ
aQ
aQ
aQ
aQ
aQ
aQ
aQ
aQ
aQ
aQ
aQ
aQ
aQ
aQ
uZ
Ht
Ht
Ht
FC
hz
jD
Sh
Sh
Sh
Sh
gy
Sh
Pi
Pi
Pi
uZ
aa
aa
aa
aa
aa
"}
(23,1,1) = {"
aa
aa
aa
aa
aa
Pi
Pi
Pi
Pi
au
au
au
au
aQ
aQ
aQ
aQ
aQ
aQ
aQ
aQ
aQ
aQ
aQ
aQ
aQ
aQ
Pi
aQ
ry
aQ
aQ
aQ
aQ
aQ
aQ
aQ
Pi
jD
Ht
Ht
Ht
Hb
Ht
Pc
Sh
Sh
Sh
Sh
Sh
CF
CF
Sh
Sh
uZ
aa
aa
aa
aa
aa
"}
(24,1,1) = {"
aa
aa
aa
aa
Pi
Pi
Pi
aQ
Pi
au
au
au
au
aQ
aQ
aQ
aQ
aQ
aQ
aQ
aQ
Pi
aQ
aQ
aQ
aQ
ry
aQ
ry
aQ
aQ
aQ
aQ
aQ
aQ
aQ
aQ
Pi
jD
Ht
Ht
Ht
Ht
Mr
uZ
Sh
Sh
Sh
Ee
KM
Sh
CF
Sh
CF
uZ
aa
aa
aa
aa
aa
"}
(25,1,1) = {"
aa
aa
aa
aa
Pi
Pi
Pi
aQ
Pi
au
aQ
aQ
aQ
aQ
aQ
aQ
aQ
aQ
aQ
aQ
aQ
aQ
aQ
aQ
aQ
aQ
ry
ry
ry
ry
aQ
aQ
aQ
aQ
ry
aQ
Pi
Pi
jD
La
Ht
Ht
Ht
RZ
jD
Sh
Sh
Sh
Sh
Sh
Sh
Sh
Sh
Sh
uZ
aa
aa
aa
aa
aa
"}
(26,1,1) = {"
aa
aa
aa
aa
aa
Pi
Pi
Pi
Pi
au
aQ
aQ
aQ
aQ
aQ
aQ
aQ
aQ
aQ
aQ
aQ
ry
aQ
ry
ry
ry
aQ
au
hx
aQ
ry
ry
aQ
aQ
aQ
aQ
Pi
Pi
uZ
uZ
jD
Is
jD
jD
jD
aQ
uZ
uZ
uZ
jD
jD
jD
Pc
uZ
uZ
aa
aa
aa
aa
aa
"}
(27,1,1) = {"
aa
aa
aa
aa
aa
Pi
Pi
Pi
KC
au
aQ
aQ
aQ
aQ
aQ
aQ
aQ
aQ
aQ
ry
ry
ry
ry
au
nf
ag
aU
au
au
au
ae
Ug
au
aQ
aQ
aQ
Pi
Pi
oo
oo
Ht
Hd
Hd
Ht
Ht
Pi
Pi
aa
aa
aa
aa
jD
Sh
uZ
aa
aa
aa
aa
aa
aa
"}
(28,1,1) = {"
aa
aa
aa
aa
Pi
Pi
aQ
Pi
au
aQ
aQ
aQ
aQ
aQ
aQ
aQ
aQ
aQ
aQ
ry
ry
ry
au
wJ
au
au
au
au
au
dq
au
aQ
aQ
aQ
aQ
aQ
Pi
Ht
Ii
IN
Ht
Sd
oy
Ht
oy
Pi
Pi
aa
aa
aa
aa
jD
Pc
uZ
aa
aa
aa
aa
aa
aa
"}
(29,1,1) = {"
aa
aa
aa
aa
Pi
Pi
aQ
au
pi
aQ
aQ
aQ
Pi
ry
ry
ry
aQ
aQ
ry
ry
ry
au
KC
au
ZC
au
au
DL
au
au
DL
ry
ry
aQ
aQ
Pi
Ii
Ht
Ht
QU
At
Ht
Ht
Ht
Ht
Pi
Pi
aa
aa
aa
aa
aa
aa
QK
aa
aa
aa
aa
aa
aa
"}
(30,1,1) = {"
aa
aa
aa
aa
Pi
aQ
Pi
au
yw
aQ
aQ
aQ
Pi
aQ
aQ
aQ
aQ
aQ
aQ
aQ
ry
yq
au
au
au
au
Ug
au
au
al
au
aQ
aQ
aQ
aQ
Pi
Ht
Ht
Ht
Ht
Ht
Ht
iw
Ht
Ht
Pi
Pi
aa
aa
aa
aa
aa
aa
aa
aa
aa
aa
aa
aa
aa
"}
(31,1,1) = {"
aa
aa
aa
aa
aQ
aQ
au
au
Ru
aQ
aQ
aQ
aQ
aQ
aQ
aQ
aQ
aQ
aQ
aQ
aQ
au
au
tG
au
au
au
gW
au
au
au
yq
aQ
aQ
aQ
Pi
Ht
Ht
Ht
At
iw
Ht
AR
oy
Ht
Pi
Pi
aa
aa
aa
QK
aa
aa
aa
aa
aa
aa
aa
aa
aa
"}
(32,1,1) = {"
aa
aa
aa
aa
aa
aa
dq
Ru
eY
aQ
aQ
aQ
ry
aQ
aQ
ry
aQ
ry
ry
aQ
ry
au
au
au
hx
au
au
au
au
Yt
au
RJ
au
aQ
aQ
Pi
Pi
Pi
Sd
Ht
Ht
Ht
NR
Ht
Pi
Pi
aa
aa
aa
aa
aa
aa
aa
aa
aa
aa
aa
aa
aa
aa
"}
(33,1,1) = {"
aa
aa
aa
aa
aa
aa
au
Ow
eY
au
aQ
aQ
aQ
aQ
aQ
ry
aQ
aQ
ry
ry
aQ
au
aQ
aQ
cf
au
au
aC
au
RJ
aQ
au
aD
ay
aQ
Pi
Pi
Ht
Ht
Ht
Ht
Ii
Ht
Ii
Pi
Pi
aa
aa
aa
aa
aa
aa
aa
aa
aa
aa
aa
aa
aa
aa
"}
(34,1,1) = {"
aa
aa
aa
aa
QK
aa
Pi
Pi
Pi
au
aQ
aQ
aQ
Pi
aQ
aQ
aQ
aQ
aQ
aQ
aQ
aQ
aQ
ry
ry
ry
dq
au
ry
ry
ry
aQ
au
QP
aQ
aQ
Pi
Pi
Pi
Pi
Pi
Pi
Ht
Ht
Pi
Pi
aa
aa
aa
aa
aa
aa
aa
aa
aa
aa
aa
aa
aa
aa
"}
(35,1,1) = {"
aa
aa
aa
aa
aa
aQ
Pi
Pi
Pi
au
au
au
aQ
Pi
aQ
aQ
ry
aQ
aQ
ry
aQ
Pi
aQ
ry
aQ
ry
au
cf
ry
ry
ry
aQ
ry
au
aQ
aQ
aQ
Pi
Pi
Pi
Pi
Pi
Pi
Pi
Pi
Pi
aa
aa
aa
aa
aa
aa
aa
aa
aa
aa
aa
aa
aa
aa
"}
(36,1,1) = {"
aa
aa
aa
aa
Pi
Pi
Pi
Pi
Pi
Pi
au
au
au
aQ
aQ
aQ
aQ
aQ
aQ
aQ
aQ
aQ
aQ
aQ
aQ
ry
ry
ry
ry
aQ
aQ
aQ
aQ
au
ry
aQ
aQ
aQ
aQ
aQ
Pi
Pi
Pi
Pi
Pi
Pi
Pi
aa
aa
aa
aa
aa
aa
aa
aa
aa
aa
aa
aa
aa
"}
(37,1,1) = {"
aa
aa
aa
aa
Pi
Pi
Pi
aQ
Pi
Pi
au
au
au
aQ
aQ
aQ
aQ
aQ
aQ
aQ
aQ
aQ
aQ
aQ
aQ
aQ
aQ
aQ
aQ
aQ
aQ
aQ
aQ
au
au
aQ
aQ
aQ
aQ
aQ
Pi
Pi
Pi
Pi
Pi
Pi
Pi
aa
aa
aa
aa
aa
aa
aa
aa
aa
aa
aa
aa
aa
"}
(38,1,1) = {"
aa
aa
aa
aa
Pi
Pi
Pi
aQ
aQ
Pi
aQ
au
ae
au
aQ
aQ
aQ
aQ
aQ
aQ
aQ
aQ
aQ
aQ
aQ
aQ
aQ
aQ
aQ
aQ
ae
aQ
ry
ry
au
aQ
ry
aQ
aQ
aQ
aQ
aQ
Pi
Pi
Pi
Pi
Pi
aa
aa
aa
aa
aa
aa
aa
aa
aa
aa
aa
aa
aa
"}
(39,1,1) = {"
aa
aa
aa
aa
Pi
Pi
Pi
Pi
aQ
Pi
aQ
aQ
au
au
aQ
aQ
au
au
aQ
aQ
aQ
aQ
aQ
Pi
aQ
aQ
aQ
aQ
aQ
aQ
aQ
aQ
aQ
aQ
au
aQ
aQ
aQ
aQ
aQ
aQ
Pi
Pi
Pi
Pi
Pi
Pi
aa
aa
aa
aa
aa
aa
aa
aa
aa
aa
aa
aa
aa
"}
(40,1,1) = {"
aa
aa
aa
aa
aQ
aQ
Pi
Pi
aQ
Pi
aQ
aQ
aQ
au
ry
aQ
au
au
au
aQ
ry
aQ
aQ
aQ
aQ
aQ
aQ
aQ
aQ
aQ
aQ
aQ
aQ
aQ
au
aQ
aQ
aQ
aQ
aQ
aQ
Pi
Pi
Pi
Pi
aa
aa
aa
aa
aa
aa
aa
aa
aa
aa
aa
aa
aa
aa
aa
"}
(41,1,1) = {"
aa
aa
aa
aa
aa
aQ
Pi
Pi
Pi
Pi
Pi
aQ
aQ
au
au
au
au
au
au
au
au
au
aQ
aQ
aQ
aQ
aQ
Pi
aQ
aQ
aQ
aQ
aQ
aQ
au
au
aQ
aQ
aQ
aQ
aQ
aQ
Pi
Pi
Pi
aa
aa
aa
aa
aa
aa
aa
aa
aa
aa
aa
aa
aa
aa
aa
"}
(42,1,1) = {"
aa
aa
aa
aa
aQ
aQ
Pi
Pi
Pi
Pi
Pi
aQ
aQ
aQ
au
au
au
au
Pi
Pi
au
au
au
aQ
aQ
aQ
aQ
aQ
aQ
aQ
aQ
Pi
aQ
aQ
au
KC
aQ
aQ
aQ
aQ
aQ
aQ
Pi
Pi
Pi
aa
aa
aa
aa
aa
aa
aa
aa
aa
aa
aa
aa
aa
aa
aa
"}
(43,1,1) = {"
aa
aa
aa
aa
aa
aQ
Pi
Pi
Pi
aQ
aQ
Pi
Pi
aQ
au
au
Pi
Pi
Pi
Pi
au
aQ
au
au
au
aQ
aQ
aQ
aQ
aQ
aQ
aQ
aQ
au
au
aQ
aQ
aQ
aQ
aQ
aQ
aQ
Pi
Pi
Pi
aa
aa
aa
aa
aa
aa
aa
aa
aa
aa
aa
aa
aa
aa
aa
"}
(44,1,1) = {"
aa
aa
aa
aa
aa
aa
aa
Pi
Pi
Pi
Pi
Pi
Pi
aQ
Pi
Pi
Pi
aQ
aQ
Pi
au
aQ
aQ
aQ
au
au
au
au
au
aQ
aQ
aQ
ry
au
au
aQ
aQ
aQ
aQ
aQ
Pi
Pi
Pi
Pi
Pi
aa
aa
aa
aa
aa
aa
aa
aa
aa
aa
aa
aa
aa
aa
aa
"}
(45,1,1) = {"
aa
aa
aa
aa
aa
aa
aa
Pi
Pi
Pi
Pi
Pi
Pi
aQ
Pi
aQ
aQ
aQ
aQ
Pi
Pi
aQ
aQ
aQ
aQ
aQ
ry
aQ
au
au
au
au
au
au
aQ
aQ
aQ
aQ
aQ
Pi
Pi
Pi
Pi
Pi
aa
aa
aa
aa
aa
aa
aa
aa
aa
aa
aa
aa
aa
aa
aa
aa
"}
(46,1,1) = {"
aa
aa
aa
aa
aa
aa
aa
Pi
Pi
Pi
Pi
Pi
Pi
Pi
Pi
Pi
Pi
Pi
aQ
aQ
Pi
Pi
aQ
aQ
aQ
aQ
Pi
aQ
aQ
aQ
aQ
aQ
aQ
aQ
Pi
Pi
aQ
aQ
aQ
Pi
Pi
Pi
Pi
Pi
aa
aa
aa
aa
QK
aa
aa
aa
aa
aa
aa
aa
aa
aa
aa
aa
"}
(47,1,1) = {"
aa
aa
aa
aa
aa
aa
aa
aa
aQ
Pi
Pi
aQ
Pi
Pi
Pi
Pi
Pi
Pi
Pi
aQ
Pi
Pi
Pi
Pi
aQ
aQ
aQ
aQ
aQ
aQ
aQ
aQ
aQ
aQ
Pi
aQ
Pi
Pi
Pi
Pi
Pi
Pi
Pi
aa
aa
aa
aa
aa
aa
aa
aa
aa
aa
aa
aa
aa
aa
QK
aa
aa
"}
(48,1,1) = {"
QK
aa
aa
aa
aa
aa
aa
aa
aQ
Pi
Pi
aQ
Pi
Pi
aQ
Pi
Pi
Pi
aQ
Pi
Pi
Pi
aQ
aQ
Pi
Pi
aQ
aQ
Pi
Pi
aQ
aQ
aQ
Pi
aQ
aQ
Pi
Pi
Pi
Pi
Pi
Pi
aa
aa
aa
aa
aa
aa
aa
aa
aa
aa
aa
aa
aa
aa
aa
aa
aa
aa
"}
(49,1,1) = {"
aa
aa
aa
aa
aa
aa
aa
aa
aa
aa
aa
aQ
aQ
Pi
aQ
aQ
Pi
Pi
Pi
Pi
aQ
Pi
Pi
Pi
Pi
Pi
Pi
Pi
Pi
Pi
Pi
aQ
aQ
Pi
aQ
aa
aa
aa
aa
aa
aa
aa
aa
aa
aa
aa
aa
aa
aa
aa
aa
aa
aa
aa
aa
aa
aa
aa
aa
aa
"}
(50,1,1) = {"
aa
aa
aa
aa
aa
aa
aa
aa
aa
aa
aa
Pi
Pi
Pi
aQ
aQ
Pi
Pi
Pi
Pi
Pi
Pi
Pi
aQ
Pi
aa
Pi
Pi
Pi
Pi
Pi
Pi
aQ
aQ
aQ
aQ
aa
aa
aa
aa
aa
QK
aa
aa
aa
aa
aa
aa
aa
aa
aa
aa
aa
aa
aa
aa
aa
aa
aa
aa
"}
(51,1,1) = {"
aa
aa
aa
aa
aa
aa
aa
aa
aa
aa
aa
aa
Pi
Pi
Pi
Pi
Pi
aQ
aQ
aQ
Pi
aa
aQ
Pi
Pi
aa
aa
aa
aa
aa
Pi
aa
aQ
aQ
aQ
aQ
aa
aa
aa
aa
aa
aa
aa
aa
aa
aa
aa
aa
aa
aa
aa
aa
aa
aa
aa
aa
aa
aa
aa
aa
"}
(52,1,1) = {"
aa
aa
aa
aa
aa
aa
aa
aa
aa
aa
aa
aa
aa
Pi
Pi
aQ
Pi
Pi
Pi
aa
aa
aa
aa
aa
aa
aa
aa
aa
aa
aa
Pi
aa
aa
aa
aa
aa
aa
aa
aa
aa
aa
aa
aa
aa
aa
aa
aa
aa
aa
aa
aa
aa
aa
aa
aa
aa
aa
aa
aa
aa
"}
(53,1,1) = {"
aa
aa
aa
aa
aa
aa
aa
aa
aa
aa
aa
aa
aa
Pi
Pi
Pi
Pi
Pi
aa
aa
aa
aa
aa
aa
aa
aa
aa
aa
aa
aa
aa
aa
aa
aa
aa
aa
aa
aa
aa
aa
aa
aa
aa
aa
aa
aa
aa
aa
aa
aa
aa
aa
aa
aa
aa
aa
aa
aa
aa
aa
"}
(54,1,1) = {"
aa
aa
aa
aa
aa
aa
aa
aa
aa
aa
aa
aa
aa
aa
aa
aa
aa
aa
aa
aa
aa
aa
aa
QK
aa
aa
aa
aa
aa
aa
aa
aa
aa
aa
aa
aa
aa
aa
aa
aa
aa
aa
aa
aa
aa
aa
aa
aa
aa
aa
aa
aa
aa
aa
aa
aa
aa
aa
aa
aa
"}
(55,1,1) = {"
aa
aa
aa
aa
aa
aa
aa
aa
aa
aa
aa
aa
aa
aa
aa
aa
aa
aa
aa
aa
aa
aa
aa
aa
aa
aa
aa
aa
aa
aa
aa
aa
aa
aa
aa
aa
aa
aa
aa
aa
aa
aa
aa
aa
aa
aa
aa
aa
aa
aa
aa
aa
aa
aa
aa
aa
aa
aa
aa
aa
"}
(56,1,1) = {"
aa
aa
aa
aa
aa
aa
aa
aa
aa
QK
aa
aa
aa
aa
aa
aa
aa
Pi
Pi
Pi
aa
aa
aa
aa
aa
aa
aa
aa
aa
aa
aa
aa
aa
aa
aa
aa
aa
aa
aa
aa
aa
aa
aa
aa
aa
aa
aa
aa
aa
aa
aa
aa
aa
aa
aa
aa
aa
aa
aa
aa
"}
(57,1,1) = {"
aa
aa
aa
aa
aa
aa
aa
aa
aa
aa
aa
aa
aa
aa
aa
aa
aa
aa
aa
aa
aa
aa
aa
aa
aa
aa
aa
aa
aa
aa
aa
aa
aa
aa
aa
aa
aa
aa
aa
aa
aa
aa
aa
aa
aa
aa
aa
aa
aa
aa
aa
aa
aa
aa
aa
aa
aa
aa
aa
aa
"}
(58,1,1) = {"
aa
aa
aa
aa
aa
aa
aa
aa
aa
aa
aa
aa
aa
aa
aa
aa
aa
aa
aa
aa
aa
aa
aa
aa
aa
aa
aa
aa
aa
aa
aa
aa
aa
aa
aa
aa
aa
aa
aa
aa
aa
aa
aa
aa
aa
aa
aa
aa
aa
aa
aa
aa
aa
aa
aa
aa
aa
aa
aa
aa
"}
(59,1,1) = {"
aa
aa
aa
aa
aa
aa
aa
aa
aa
aa
aa
aa
aa
aa
aa
aa
aa
aa
aa
aa
aa
aa
aa
aa
aa
aa
aa
aa
aa
aa
aa
aa
aa
aa
aa
aa
aa
aa
aa
aa
aa
aa
aa
aa
aa
aa
aa
aa
aa
aa
aa
aa
aa
aa
aa
aa
aa
aa
aa
aa
"}
(60,1,1) = {"
aa
aa
aa
aa
aa
aa
aa
aa
aa
aa
aa
aa
aa
aa
aa
aa
aa
aa
aa
aa
aa
aa
aa
aa
aa
aa
aa
aa
aa
aa
aa
aa
aa
aa
aa
aa
aa
aa
aa
aa
aa
aa
aa
aa
aa
aa
aa
aa
aa
aa
aa
aa
aa
aa
aa
aa
aa
aa
aa
aa
"}
