//MAP CONVERTED BY dmm2tgm.py THIS HEADER COMMENT PREVENTS RECONVERSION, DO NOT REMOVE
"a" = (
/obj/structure/chair/comfy/shuttle{
	dir = 8
	},
/obj/structure/window/reinforced{
	dir = 4
	},
/turf/open/floor/mineral/titanium/white,
/area/shuttle/escape)
"b" = (
/turf/open/floor/mineral/plastitanium/red/brig,
/area/shuttle/escape)
"c" = (
/obj/item/radio/intercom{
	name = "Station Intercom (General)";
	pixel_y = -29
	},
/turf/open/floor/mineral/titanium,
/area/shuttle/escape)
"d" = (
/obj/machinery/computer/crew{
	dir = 4
	},
/turf/open/floor/mineral/titanium/blue,
/area/shuttle/escape)
"e" = (
/obj/structure/chair/comfy/shuttle{
	dir = 4
	},
/obj/structure/window/reinforced{
	dir = 8
	},
/turf/open/floor/mineral/titanium/blue,
/area/shuttle/escape)
"f" = (
/obj/structure/chair/comfy/shuttle{
	dir = 4
	},
/obj/effect/turf_decal/tile/red{
	dir = 8
	},
/obj/effect/turf_decal/tile/red{
	dir = 1
	},
/obj/effect/turf_decal/tile/red{
	dir = 4
	},
/obj/effect/turf_decal/tile/red,
/turf/open/floor/mineral/titanium,
/area/shuttle/escape)
"g" = (
/obj/machinery/computer/security{
	dir = 8
	},
/turf/open/floor/mineral/titanium/blue,
/area/shuttle/escape)
"h" = (
/obj/structure/closet/crate,
/turf/open/floor/mineral/titanium/yellow,
/area/shuttle/escape)
"j" = (
/obj/structure/chair/comfy/shuttle{
	dir = 4
	},
/obj/effect/turf_decal/tile/red,
/obj/effect/turf_decal/tile/red{
	dir = 8
	},
/obj/effect/turf_decal/tile/red{
	dir = 1
	},
/obj/effect/turf_decal/tile/red{
	dir = 4
	},
/turf/open/floor/mineral/titanium,
/area/shuttle/escape)
"k" = (
/obj/structure/extinguisher_cabinet{
	pixel_x = 27
	},
/turf/open/floor/mineral/titanium/white,
/area/shuttle/escape)
"l" = (
/obj/machinery/door/airlock/titanium{
	name = "Emergency Shuttle Airlock";
	req_access_txt = "2"
	},
/turf/open/floor/mineral/titanium,
/area/shuttle/escape)
"m" = (
/obj/structure/closet,
/turf/open/floor/mineral/titanium/yellow,
/area/shuttle/escape)
"n" = (
/obj/machinery/door/airlock/public/glass{
	name = "Emergency Shuttle Cockpit";
	req_access_txt = "19"
	},
/turf/open/floor/mineral/titanium,
/area/shuttle/escape)
"o" = (
/obj/structure/table,
/obj/item/storage/firstaid/regular{
	pixel_x = 2;
	pixel_y = 3
	},
/obj/item/crowbar,
/obj/item/storage/firstaid/fire,
/turf/open/floor/mineral/titanium/blue,
/area/shuttle/escape)
"p" = (
/obj/machinery/door/airlock/public/glass{
	name = "Emergency Shuttle Infirmary"
	},
/turf/open/floor/mineral/titanium/white,
/area/shuttle/escape)
"q" = (
/obj/structure/closet/emcloset,
/turf/open/floor/mineral/titanium,
/area/shuttle/escape)
"r" = (
/obj/structure/chair/comfy/shuttle{
	dir = 4
	},
/turf/open/floor/mineral/titanium/yellow,
/area/shuttle/escape)
"s" = (
/obj/structure/chair/comfy/shuttle{
	dir = 8
	},
/turf/open/floor/mineral/titanium/blue,
/area/shuttle/escape)
"u" = (
/obj/machinery/door/airlock/titanium{
	name = "Emergency Shuttle Airlock"
	},
/turf/open/floor/mineral/titanium,
/area/shuttle/escape)
"v" = (
/obj/machinery/computer/atmos_alert,
/turf/open/floor/mineral/titanium/blue,
/area/shuttle/escape)
"w" = (
/obj/structure/closet/emcloset,
/turf/open/floor/mineral/titanium/white,
/area/shuttle/escape)
"y" = (
/obj/structure/chair/comfy/shuttle{
	dir = 8
	},
/turf/open/floor/mineral/titanium/white,
/area/shuttle/escape)
"z" = (
/turf/open/floor/mineral/titanium/white,
/area/shuttle/escape)
"A" = (
/obj/structure/chair/comfy/shuttle{
	dir = 8
	},
/turf/open/floor/mineral/titanium/yellow,
/area/shuttle/escape)
"B" = (
/turf/open/floor/mineral/titanium/yellow,
/area/shuttle/escape)
"C" = (
/obj/structure/chair/comfy/shuttle{
	dir = 1
	},
/turf/open/floor/mineral/plastitanium/red/brig,
/area/shuttle/escape)
"D" = (
/obj/structure/chair/comfy/shuttle,
/turf/open/floor/mineral/plastitanium/red/brig,
/area/shuttle/escape)
"E" = (
/obj/machinery/stasis,
/turf/open/floor/mineral/titanium/white,
/area/shuttle/escape)
"F" = (
/obj/structure/chair/comfy/shuttle{
	dir = 8
	},
/turf/open/floor/mineral/titanium/purple,
/area/shuttle/escape)
"G" = (
/turf/closed/wall/mineral/titanium,
/area/shuttle/escape)
"H" = (
/obj/machinery/flasher{
	id = "shuttle_flasher";
	pixel_x = -24;
	pixel_y = 6
	},
/obj/machinery/button/flasher{
	id = "shuttle_flasher";
	pixel_x = -24;
	pixel_y = -6
	},
/obj/structure/chair/comfy/shuttle,
/turf/open/floor/mineral/plastitanium/red/brig,
/area/shuttle/escape)
"J" = (
/obj/machinery/computer/emergency_shuttle,
/turf/open/floor/mineral/titanium/blue,
/area/shuttle/escape)
"K" = (
/obj/machinery/vending/wallmed{
	name = "Emergency NanoMed";
	use_power = 0
	},
/turf/closed/wall/mineral/titanium,
/area/shuttle/escape)
"L" = (
/obj/docking_port/mobile/emergency{
	dwidth = 13;
	height = 9;
	name = "Midway emergency shuttle";
	width = 26
	},
/obj/machinery/door/airlock/titanium{
	name = "Emergency Shuttle Airlock"
	},
/turf/open/floor/mineral/titanium,
/area/shuttle/escape)
"M" = (
/obj/structure/chair/comfy/shuttle{
	dir = 4
	},
/turf/open/floor/mineral/titanium/white,
/area/shuttle/escape)
"N" = (
/obj/effect/spawner/structure/window/shuttle,
/turf/open/floor/plating,
/area/shuttle/escape)
"O" = (
/obj/structure/chair/comfy/shuttle{
	dir = 1
	},
/turf/open/floor/mineral/titanium,
/area/shuttle/escape)
"P" = (
/obj/machinery/door/airlock/titanium{
	name = "Emergency Shuttle Cargo"
	},
/turf/open/floor/mineral/titanium/blue,
/area/shuttle/escape)
"Q" = (
/obj/machinery/sleeper{
	dir = 8
	},
/turf/open/floor/mineral/titanium/white,
/area/shuttle/escape)
"R" = (
/turf/open/floor/mineral/titanium,
/area/shuttle/escape)
"S" = (
/obj/machinery/computer/communications,
/turf/open/floor/mineral/titanium/blue,
/area/shuttle/escape)
"T" = (
/obj/machinery/door/airlock/public/glass{
	name = "Emergency Shuttle Brig";
	req_access_txt = "2"
	},
/turf/open/floor/mineral/titanium,
/area/shuttle/escape)
"U" = (
/obj/structure/shuttle/engine/heater,
/turf/closed/wall/mineral/titanium,
/area/shuttle/escape)
"V" = (
/obj/structure/table,
/obj/machinery/recharger,
/turf/open/floor/mineral/titanium/blue,
/area/shuttle/escape)
"W" = (
/obj/structure/closet/emcloset,
/turf/open/floor/mineral/titanium/blue,
/area/shuttle/escape)
"X" = (
/obj/structure/chair/comfy/shuttle,
/turf/open/floor/mineral/titanium/blue,
/area/shuttle/escape)
"Y" = (
/turf/open/space/basic,
/area/space)
"Z" = (
/obj/structure/shuttle/engine/propulsion,
/turf/open/space/basic,
/area/shuttle/escape)

(1,1,1) = {"
Y
Y
Y
Y
N
N
G
u
N
G
N
G
L
G
N
G
G
l
G
G
G
G
G
G
U
Z
"}
(2,1,1) = {"
Y
N
N
G
G
r
r
R
r
M
M
M
R
M
M
G
H
b
b
C
G
m
B
m
U
Z
"}
(3,1,1) = {"
N
N
d
V
G
R
R
R
R
R
R
R
R
R
R
G
D
b
b
C
G
h
B
h
G
G
"}
(4,1,1) = {"
N
v
O
c
G
A
A
R
A
y
y
y
R
a
a
K
G
T
G
G
G
G
P
G
G
G
"}
(5,1,1) = {"
N
J
O
R
n
R
R
R
R
R
R
R
R
e
e
f
f
R
f
j
r
r
R
r
q
N
"}
(6,1,1) = {"
N
S
O
R
G
N
p
p
N
N
X
R
R
R
R
R
R
R
R
R
R
R
R
R
q
N
"}
(7,1,1) = {"
N
N
g
o
G
w
z
z
w
N
X
R
R
R
R
R
R
R
R
R
R
R
R
R
G
G
"}
(8,1,1) = {"
Y
N
N
G
G
E
z
k
Q
N
W
s
s
F
F
F
F
F
A
A
A
A
A
A
U
Z
"}
(9,1,1) = {"
Y
Y
Y
Y
N
N
K
G
N
N
G
G
G
G
N
N
N
N
G
G
G
N
N
N
U
Z
"}
