//MAP CONVERTED BY dmm2tgm.py THIS HEADER COMMENT PREVENTS RECONVERSION, DO NOT REMOVE
"c" = (
/turf/open/floor/mineral/titanium,
/area/shuttle/mining)
"f" = (
/obj/effect/spawner/structure/window/shuttle,
/turf/open/floor/plating,
/area/shuttle/mining)
"l" = (
/obj/machinery/door/airlock/titanium{
	name = "Mining Shuttle Airlock"
	},
/obj/docking_port/mobile{
	dir = 8;
	dwidth = 2;
	height = 7;
	id = "mining";
	name = "mining shuttle";
	port_direction = 4;
	width = 5
	},
/turf/open/floor/mineral/titanium,
/area/shuttle/mining)
"n" = (
/obj/structure/shuttle/engine/propulsion/burst{
	dir = 4
	},
/turf/open/space/basic,
/area/shuttle/mining)
"o" = (
/obj/machinery/light/small,
/turf/open/floor/mineral/titanium,
/area/shuttle/mining)
"r" = (
/turf/open/floor/mineral/titanium/blue,
/area/shuttle/mining)
"t" = (
/obj/structure/chair/comfy/shuttle{
	dir = 8
	},
/obj/structure/window/reinforced{
	dir = 4
	},
/turf/open/floor/mineral/titanium,
/area/shuttle/mining)
"x" = (
/obj/machinery/computer/shuttle/mining{
	dir = 4
	},
/turf/open/floor/mineral/titanium/blue,
/area/shuttle/mining)
"D" = (
/obj/machinery/light/small{
	dir = 1
	},
/turf/open/floor/mineral/titanium,
/area/shuttle/mining)
"G" = (
/obj/effect/spawner/structure/window/shuttle,
/obj/structure/shuttle/engine/heater{
	dir = 4
	},
/turf/open/floor/plating,
/area/shuttle/mining)
"I" = (
/obj/structure/chair/comfy/shuttle{
	dir = 8
	},
/turf/open/floor/mineral/titanium,
/area/shuttle/mining)
"N" = (
/obj/structure/ore_box,
/obj/structure/extinguisher_cabinet{
	pixel_x = 24
	},
/obj/effect/turf_decal/bot,
/turf/open/floor/mineral/titanium/blue,
/area/shuttle/mining)
"O" = (
/obj/structure/closet/crate/internals,
/obj/item/clothing/head/hardhat/orange{
	name = "protective hat";
	pixel_y = 9
	},
/obj/item/clothing/head/hardhat/orange{
	name = "protective hat";
	pixel_y = 9
	},
/obj/item/clothing/mask/breath{
	pixel_x = -3;
	pixel_y = -3
	},
/obj/item/clothing/mask/breath{
	pixel_x = -3;
	pixel_y = -3
	},
/obj/item/tank/internals/emergency_oxygen{
	pixel_x = 3
	},
/obj/item/tank/internals/emergency_oxygen{
	pixel_x = 3
	},
/obj/item/clothing/suit/hazardvest{
	desc = "A high-visibility lifejacket complete with whistle and slot for oxygen tanks.";
	name = "emergency lifejacket"
	},
/obj/item/clothing/suit/hazardvest{
	desc = "A high-visibility lifejacket complete with whistle and slot for oxygen tanks.";
	name = "emergency lifejacket"
	},
/obj/item/storage/toolbox/emergency,
/obj/effect/turf_decal/bot,
/turf/open/floor/mineral/titanium/blue,
/area/shuttle/mining)
"P" = (
/turf/closed/wall/mineral/titanium,
/area/shuttle/mining)
"T" = (
/obj/structure/table,
/obj/item/radio/intercom{
	pixel_y = -29
	},
/obj/item/storage/firstaid/regular,
/turf/open/floor/mineral/titanium/blue,
/area/shuttle/mining)
"X" = (
/obj/structure/table,
/obj/item/radio,
/obj/item/screwdriver{
	pixel_y = 18
	},
/turf/open/floor/mineral/titanium/blue,
/area/shuttle/mining)

(1,1,1) = {"
P
P
f
P
P
"}
(2,1,1) = {"
P
X
x
T
P
"}
(3,1,1) = {"
f
c
I
c
f
"}
(4,1,1) = {"
P
D
c
o
P
"}
(5,1,1) = {"
f
t
c
t
f
"}
(6,1,1) = {"
G
N
r
O
G
"}
(7,1,1) = {"
n
P
l
P
n
"}
