//MAP CONVERTED BY dmm2tgm.py THIS HEADER COMMENT PREVENTS RECONVERSION, DO NOT REMOVE
"ao" = (
/obj/effect/turf_decal/caution,
/obj/machinery/atmospherics/components/unary/vent_pump/on{
	dir = 1
	},
/obj/effect/decal/cleanable/dirt/dust,
/obj/effect/decal/cleanable/dirt,
/turf/open/floor/plating,
/area/shuttle/abandoned/engine)
"au" = (
/obj/effect/spawner/structure/window/shuttle,
/obj/machinery/door/poddoor{
	id = "whiteship_windows"
	},
/turf/open/floor/plating,
/area/shuttle/abandoned/cargo)
"aV" = (
/obj/machinery/atmospherics/components/unary/vent_pump/on{
	dir = 1
	},
/obj/effect/decal/cleanable/dirt/dust,
/obj/effect/decal/cleanable/dirt,
/turf/open/floor/plasteel/dark,
/area/shuttle/abandoned/cargo)
"bg" = (
/obj/machinery/atmospherics/components/unary/vent_pump/on,
/obj/effect/decal/cleanable/dirt/dust,
/turf/open/floor/engine,
/area/shuttle/abandoned/cargo)
"bn" = (
/turf/closed/wall/mineral/titanium,
/area/shuttle/abandoned/engine)
"cF" = (
/obj/machinery/airalarm/directional/east{
	pixel_x = 24
	},
/obj/effect/decal/cleanable/dirt/dust,
/obj/effect/decal/cleanable/dirt,
/turf/open/floor/plating,
/area/shuttle/abandoned/engine)
"dy" = (
/obj/effect/decal/cleanable/dirt/dust,
/obj/effect/decal/cleanable/dirt,
/turf/open/floor/plasteel/dark,
/area/shuttle/abandoned/cargo)
"dN" = (
/obj/machinery/door/airlock/titanium/glass,
/obj/machinery/atmospherics/pipe/simple/supply/hidden{
	dir = 4
	},
/obj/structure/cable{
	icon_state = "4-8"
	},
/obj/effect/decal/cleanable/dirt/dust,
/obj/effect/decal/cleanable/dirt,
/turf/open/floor/plasteel/dark,
/area/shuttle/abandoned/bridge)
"eo" = (
/obj/effect/spawner/structure/window/shuttle,
/obj/machinery/door/poddoor{
	id = "whiteship_bridge"
	},
/obj/machinery/door/firedoor/border_only,
/obj/machinery/door/firedoor/border_only{
	dir = 4
	},
/turf/open/floor/plating,
/area/shuttle/abandoned/bridge)
"er" = (
/obj/machinery/atmospherics/components/unary/vent_pump/on{
	dir = 8
	},
/obj/structure/cable{
	icon_state = "1-8"
	},
/obj/effect/decal/cleanable/dirt/dust,
/obj/effect/decal/cleanable/dirt,
/turf/open/floor/plasteel/dark,
/area/shuttle/abandoned/bridge)
"eQ" = (
/obj/effect/turf_decal/box/corners{
	dir = 1
	},
/obj/effect/decal/cleanable/dirt/dust,
/turf/open/floor/engine,
/area/shuttle/abandoned/cargo)
"eT" = (
/obj/structure/spacepoddoor{
	dir = 4
	},
/obj/machinery/door/poddoor/multi_tile/four_tile_hor{
	id = "pubbywspodsw"
	},
/turf/open/floor/engine,
/area/shuttle/abandoned/cargo)
"fm" = (
/obj/structure/cable{
	icon_state = "4-8"
	},
/obj/effect/decal/cleanable/dirt/dust,
/obj/effect/decal/cleanable/dirt,
/turf/open/floor/plating,
/area/shuttle/abandoned/engine)
"gB" = (
/obj/effect/turf_decal/box/corners,
/obj/effect/decal/cleanable/dirt/dust,
/turf/open/floor/engine,
/area/shuttle/abandoned/cargo)
"gH" = (
/obj/structure/window/reinforced,
/obj/effect/turf_decal/box,
/obj/structure/closet/crate,
/obj/item/mining_scanner,
/obj/item/mining_scanner,
/obj/item/storage/belt/mining,
/obj/item/storage/belt/mining,
/obj/item/storage/bag/ore,
/obj/item/storage/bag/ore,
/obj/effect/decal/cleanable/dirt/dust,
/obj/effect/decal/cleanable/dirt,
/turf/open/floor/plasteel,
/area/shuttle/abandoned/cargo)
"gU" = (
/obj/structure/chair{
	dir = 8
	},
/obj/structure/cable{
	icon_state = "1-8"
	},
/obj/effect/decal/cleanable/dirt/dust,
/obj/effect/decal/cleanable/dirt,
/turf/open/floor/plating,
/area/shuttle/abandoned/engine)
"hT" = (
/obj/structure/table,
/obj/machinery/cell_charger,
/obj/item/stock_parts/cell/hyper,
/obj/effect/decal/cleanable/dirt/dust,
/obj/effect/decal/cleanable/dirt,
/turf/open/floor/plating,
/area/shuttle/abandoned/engine)
"hZ" = (
/obj/effect/decal/cleanable/dirt/dust,
/obj/effect/decal/cleanable/dirt,
/obj/machinery/airalarm/directional{
	dir = 1;
	pixel_y = -24
	},
/obj/structure/table/reinforced,
/obj/item/laser_pointer,
/turf/open/floor/plasteel/dark,
/area/shuttle/abandoned/bridge)
"ih" = (
/obj/structure/spacepoddoor{
	dir = 4
	},
/obj/machinery/door/poddoor/multi_tile/four_tile_hor{
	id = "pubbywspodne"
	},
/turf/open/floor/engine,
/area/shuttle/abandoned/cargo)
"in" = (
/obj/effect/turf_decal/stripes/line{
	dir = 8
	},
/obj/effect/decal/cleanable/dirt/dust,
/obj/effect/decal/cleanable/dirt,
/turf/open/floor/plating,
/area/shuttle/abandoned/engine)
"iS" = (
/obj/machinery/door/poddoor{
	id = "whiteship_bridge"
	},
/obj/machinery/door/firedoor/border_only{
	dir = 4
	},
/obj/effect/spawner/structure/window/shuttle,
/turf/open/floor/plating,
/area/shuttle/abandoned/bridge)
"jf" = (
/obj/effect/spawner/structure/window/shuttle,
/obj/machinery/door/poddoor{
	id = "whiteship_bridge"
	},
/obj/machinery/door/firedoor/border_only{
	dir = 1
	},
/obj/machinery/door/firedoor/border_only{
	dir = 4
	},
/turf/open/floor/plating,
/area/shuttle/abandoned/bridge)
"jH" = (
/obj/machinery/button/door{
	id = "pubbywspodne";
	name = "Pod Door Control";
	pixel_x = 24;
	pixel_y = 0
	},
/obj/effect/decal/cleanable/dirt/dust,
/turf/open/floor/engine,
/area/shuttle/abandoned/cargo)
"jK" = (
/obj/effect/decal/cleanable/dirt/dust,
/obj/effect/decal/cleanable/dirt,
/turf/open/floor/plating,
/area/shuttle/abandoned/engine)
"jQ" = (
/obj/machinery/atmospherics/components/unary/vent_pump/on{
	dir = 1
	},
/obj/effect/decal/cleanable/dirt/dust,
/turf/open/floor/engine,
/area/shuttle/abandoned/cargo)
"kA" = (
/obj/effect/spawner/structure/window/shuttle,
/obj/machinery/door/poddoor{
	id = "whiteship_bridge"
	},
/turf/open/floor/plating,
/area/shuttle/abandoned/bridge)
"kJ" = (
/obj/machinery/light{
	dir = 4
	},
/obj/effect/decal/cleanable/dirt/dust,
/turf/open/floor/engine,
/area/shuttle/abandoned/cargo)
"ml" = (
/obj/effect/turf_decal/stripes/line{
	dir = 4
	},
/obj/machinery/light,
/obj/effect/decal/cleanable/dirt/dust,
/obj/effect/decal/cleanable/dirt,
/turf/open/floor/plating,
/area/shuttle/abandoned/engine)
"mr" = (
/obj/machinery/atmospherics/pipe/simple/supply/hidden,
/obj/effect/decal/cleanable/dirt/dust,
/obj/effect/decal/cleanable/dirt,
/turf/open/floor/plasteel/dark,
/area/shuttle/abandoned/cargo)
"mt" = (
/obj/machinery/atmospherics/pipe/simple/supply/hidden{
	dir = 4
	},
/obj/structure/cable{
	icon_state = "1-4"
	},
/obj/structure/cable{
	icon_state = "4-8"
	},
/obj/effect/decal/cleanable/dirt/dust,
/obj/effect/decal/cleanable/dirt,
/turf/open/floor/plasteel/dark,
/area/shuttle/abandoned/cargo)
"mL" = (
/obj/structure/window/reinforced{
	dir = 1;
	layer = 2.9
	},
/obj/effect/turf_decal/box,
/obj/structure/table/reinforced,
/obj/machinery/atmospherics/pipe/simple/supply/hidden,
/obj/item/storage/toolbox/electrical,
/obj/item/storage/toolbox/electrical,
/obj/effect/decal/cleanable/dirt/dust,
/obj/effect/decal/cleanable/dirt,
/turf/open/floor/plasteel,
/area/shuttle/abandoned/cargo)
"nv" = (
/obj/effect/turf_decal/stripes/line{
	dir = 8
	},
/obj/machinery/atmospherics/pipe/simple/supply/hidden,
/obj/effect/decal/cleanable/dirt/dust,
/obj/effect/decal/cleanable/dirt,
/turf/open/floor/plating,
/area/shuttle/abandoned/engine)
"nB" = (
/obj/effect/decal/cleanable/dirt/dust,
/obj/effect/decal/cleanable/dirt,
/obj/machinery/button/door{
	id = "whiteship_windows";
	name = "Windows Blast Door Control";
	pixel_x = -5;
	pixel_y = 26
	},
/obj/machinery/button/door{
	id = "whiteship_bridge";
	name = "Bridge Blast Door Control";
	pixel_x = 5;
	pixel_y = 26
	},
/obj/structure/table/reinforced,
/obj/item/paper_bin{
	pixel_x = -4
	},
/obj/item/folder/blue{
	pixel_x = 3;
	pixel_y = 2
	},
/obj/item/folder/white,
/obj/item/pen{
	pixel_x = 4
	},
/turf/open/floor/plasteel/dark,
/area/shuttle/abandoned/bridge)
"nS" = (
/obj/effect/turf_decal/caution,
/obj/machinery/atmospherics/pipe/simple/supply/hidden,
/obj/effect/decal/cleanable/dirt/dust,
/obj/effect/decal/cleanable/dirt,
/turf/open/floor/plating,
/area/shuttle/abandoned/engine)
"od" = (
/obj/structure/window/reinforced{
	dir = 1;
	layer = 2.9
	},
/obj/effect/turf_decal/box,
/obj/structure/table/reinforced,
/obj/item/storage/toolbox/mechanical,
/obj/item/storage/toolbox/mechanical,
/obj/effect/decal/cleanable/dirt/dust,
/obj/effect/decal/cleanable/dirt,
/turf/open/floor/plasteel,
/area/shuttle/abandoned/cargo)
"ol" = (
/obj/structure/window/reinforced,
/obj/effect/turf_decal/box,
/obj/structure/table/reinforced,
/obj/item/multitool,
/obj/item/multitool,
/obj/machinery/light{
	dir = 8
	},
/obj/effect/decal/cleanable/dirt/dust,
/obj/effect/decal/cleanable/dirt,
/turf/open/floor/plasteel,
/area/shuttle/abandoned/cargo)
"on" = (
/obj/effect/turf_decal/caution/stand_clear,
/obj/effect/turf_decal/stripes/line,
/obj/machinery/button/door{
	id = "pubbywspodsw";
	name = "Pod Door Control";
	pixel_x = -24;
	pixel_y = 0
	},
/obj/machinery/light{
	dir = 8
	},
/obj/effect/decal/cleanable/dirt/dust,
/turf/open/floor/engine,
/area/shuttle/abandoned/cargo)
"oH" = (
/obj/structure/shuttle/engine/propulsion/left{
	dir = 8
	},
/turf/closed/wall/mineral/titanium,
/area/shuttle/abandoned/engine)
"oT" = (
/obj/machinery/door/airlock/titanium,
/obj/effect/decal/cleanable/dirt/dust,
/obj/effect/decal/cleanable/dirt,
/turf/open/floor/plasteel/dark,
/area/shuttle/abandoned/engine)
"pt" = (
/obj/machinery/door/airlock/external,
/obj/effect/mapping_helpers/airlock/cyclelink_helper{
	dir = 8
	},
/obj/machinery/atmospherics/pipe/simple/supply/hidden{
	dir = 4
	},
/obj/machinery/door/firedoor/border_only{
	dir = 4
	},
/obj/machinery/door/firedoor/border_only{
	dir = 8
	},
/obj/effect/decal/cleanable/dirt/dust,
/obj/effect/decal/cleanable/dirt,
/turf/open/floor/plating,
/area/shuttle/abandoned/engine)
"pu" = (
/obj/machinery/computer/crew{
	dir = 8
	},
/obj/effect/decal/cleanable/dirt/dust,
/obj/effect/decal/cleanable/dirt,
/turf/open/floor/plasteel/dark,
/area/shuttle/abandoned/bridge)
"pA" = (
/obj/machinery/door/airlock/titanium,
/obj/machinery/atmospherics/pipe/simple/supply/hidden{
	dir = 4
	},
/obj/structure/cable{
	icon_state = "4-8"
	},
/obj/effect/decal/cleanable/dirt/dust,
/obj/effect/decal/cleanable/dirt,
/turf/open/floor/plasteel/dark,
/area/shuttle/abandoned/engine)
"pU" = (
/obj/structure/spacepoddoor{
	dir = 4
	},
/obj/machinery/door/poddoor/multi_tile/four_tile_hor{
	id = "pubbywspodse"
	},
/turf/open/floor/engine,
/area/shuttle/abandoned/cargo)
"pY" = (
/obj/effect/turf_decal/stripes/line{
	dir = 4
	},
/obj/machinery/atmospherics/pipe/simple/supply/hidden{
	dir = 4
	},
/obj/machinery/light{
	dir = 1
	},
/obj/effect/decal/cleanable/dirt/dust,
/obj/effect/decal/cleanable/dirt,
/turf/open/floor/plating,
/area/shuttle/abandoned/engine)
"qx" = (
/turf/template_noop,
/area/template_noop)
"re" = (
/obj/machinery/light{
	dir = 8
	},
/obj/effect/decal/cleanable/dirt/dust,
/obj/effect/decal/cleanable/dirt,
/turf/open/floor/plasteel/dark,
/area/shuttle/abandoned/bridge)
"sh" = (
/obj/machinery/atmospherics/pipe/manifold4w/supply/hidden,
/obj/structure/cable{
	icon_state = "4-8"
	},
/obj/effect/decal/cleanable/dirt/dust,
/obj/effect/decal/cleanable/dirt,
/turf/open/floor/plasteel/dark,
/area/shuttle/abandoned/cargo)
"ss" = (
/obj/effect/turf_decal/caution/stand_clear,
/obj/effect/turf_decal/stripes/line{
	dir = 1
	},
/obj/effect/decal/cleanable/dirt/dust,
/turf/open/floor/engine,
/area/shuttle/abandoned/cargo)
"tp" = (
/obj/structure/cable{
	icon_state = "1-2"
	},
/obj/effect/decal/cleanable/dirt/dust,
/obj/effect/decal/cleanable/dirt,
/turf/open/floor/plating,
/area/shuttle/abandoned/engine)
"tv" = (
/obj/effect/spawner/structure/window/shuttle,
/obj/machinery/door/poddoor{
	id = "whiteship_bridge"
	},
/obj/machinery/door/firedoor/border_only{
	dir = 4
	},
/turf/open/floor/plating,
/area/shuttle/abandoned/bridge)
"tN" = (
/obj/effect/decal/cleanable/dirt/dust,
/obj/structure/chair/comfy/shuttle{
	dir = 4
	},
/obj/effect/decal/cleanable/dirt,
/mob/living/simple_animal/hostile/hivebot/strong,
/turf/open/floor/plasteel/dark,
/area/shuttle/abandoned/bridge)
"uf" = (
/obj/structure/chair{
	dir = 8
	},
/obj/effect/decal/cleanable/dirt/dust,
/obj/effect/decal/cleanable/dirt,
/turf/open/floor/plating,
/area/shuttle/abandoned/engine)
"vG" = (
/obj/structure/table/reinforced,
/obj/item/gps{
	gpstag = "NTREC1";
	pixel_x = -9;
	pixel_y = 7
	},
/obj/effect/decal/cleanable/dirt/dust,
/obj/effect/decal/cleanable/dirt,
/obj/item/radio/off{
	pixel_x = 6;
	pixel_y = 14
	},
/turf/open/floor/plasteel/dark,
/area/shuttle/abandoned/bridge)
"wy" = (
/obj/machinery/door/window/westleft,
/obj/effect/decal/cleanable/dirt/dust,
/obj/effect/decal/cleanable/dirt,
/turf/open/floor/plasteel/dark,
/area/shuttle/abandoned/cargo)
"xh" = (
/obj/effect/turf_decal/box/corners,
/obj/effect/decal/cleanable/dirt/dust,
/mob/living/simple_animal/hostile/hivebot,
/turf/open/floor/engine,
/area/shuttle/abandoned/cargo)
"xG" = (
/obj/spacepod,
/obj/effect/turf_decal/box/corners{
	dir = 8
	},
/obj/effect/decal/cleanable/dirt/dust,
/turf/open/floor/engine,
/area/shuttle/abandoned/cargo)
"yR" = (
/obj/structure/window/reinforced{
	dir = 1;
	layer = 2.9
	},
/obj/effect/turf_decal/box,
/obj/structure/table/reinforced,
/obj/effect/spawner/lootdrop/donkpockets,
/obj/effect/spawner/lootdrop/donkpockets,
/obj/effect/spawner/lootdrop/donkpockets,
/obj/effect/decal/cleanable/dirt/dust,
/obj/effect/decal/cleanable/dirt,
/turf/open/floor/plasteel,
/area/shuttle/abandoned/cargo)
"zv" = (
/turf/closed/wall/mineral/titanium/nodiagonal,
/area/shuttle/abandoned/cargo)
"Al" = (
/obj/machinery/atmospherics/pipe/simple/supply/hidden{
	dir = 9
	},
/obj/structure/chair{
	dir = 8
	},
/obj/effect/decal/cleanable/dirt/dust,
/obj/effect/decal/cleanable/dirt,
/turf/open/floor/plating,
/area/shuttle/abandoned/engine)
"AO" = (
/obj/machinery/door/airlock/external/glass,
/obj/effect/mapping_helpers/airlock/cyclelink_helper{
	dir = 1
	},
/obj/machinery/door/firedoor/border_only{
	dir = 1
	},
/obj/machinery/door/firedoor/border_only,
/obj/effect/decal/cleanable/dirt/dust,
/obj/effect/decal/cleanable/dirt,
/turf/open/floor/plasteel/dark,
/area/shuttle/abandoned/cargo)
"Bh" = (
/obj/structure/table/reinforced,
/obj/machinery/recharger,
/obj/machinery/power/apc/auto_name/north{
	pixel_y = 24
	},
/obj/structure/cable{
	icon_state = "0-2"
	},
/obj/effect/decal/cleanable/dirt/dust,
/obj/effect/decal/cleanable/dirt,
/turf/open/floor/plasteel/dark,
/area/shuttle/abandoned/bridge)
"BB" = (
/obj/structure/window/reinforced{
	dir = 1;
	layer = 2.9
	},
/obj/effect/turf_decal/box,
/obj/machinery/power/apc/auto_name/east{
	pixel_x = 24
	},
/obj/structure/closet/crate/secure/weapon,
/obj/item/gun/energy/laser/retro,
/obj/item/gun/energy/laser/retro,
/obj/machinery/light{
	dir = 4
	},
/obj/structure/cable{
	icon_state = "0-2"
	},
/obj/effect/decal/cleanable/dirt/dust,
/obj/effect/decal/cleanable/dirt,
/turf/open/floor/plasteel,
/area/shuttle/abandoned/cargo)
"BR" = (
/obj/effect/turf_decal/stripes/line{
	dir = 8
	},
/obj/machinery/atmospherics/pipe/manifold4w/supply/hidden,
/obj/effect/decal/cleanable/dirt/dust,
/obj/effect/decal/cleanable/dirt,
/turf/open/floor/plating,
/area/shuttle/abandoned/engine)
"Cd" = (
/obj/structure/reagent_dispensers/watertank,
/obj/effect/decal/cleanable/dirt/dust,
/obj/effect/decal/cleanable/dirt,
/turf/open/floor/plating,
/area/shuttle/abandoned/engine)
"Cs" = (
/obj/machinery/atmospherics/pipe/simple/supply/hidden,
/obj/effect/decal/cleanable/dirt/dust,
/mob/living/simple_animal/hostile/hivebot,
/obj/effect/decal/cleanable/dirt,
/turf/open/floor/plasteel/dark,
/area/shuttle/abandoned/cargo)
"Do" = (
/obj/machinery/door/window/westright,
/obj/effect/decal/cleanable/dirt/dust,
/obj/effect/decal/cleanable/dirt,
/turf/open/floor/plasteel/dark,
/area/shuttle/abandoned/cargo)
"Ea" = (
/obj/structure/spacepoddoor{
	dir = 4
	},
/obj/machinery/door/poddoor/multi_tile/four_tile_hor{
	id = "pubbywspodnw"
	},
/turf/open/floor/engine,
/area/shuttle/abandoned/cargo)
"Ei" = (
/obj/effect/decal/cleanable/dirt/dust,
/obj/machinery/computer/shuttle/white_ship{
	dir = 8
	},
/obj/effect/decal/cleanable/dirt,
/turf/open/floor/plasteel/dark,
/area/shuttle/abandoned/bridge)
"Eq" = (
/obj/structure/window/reinforced,
/obj/effect/turf_decal/box,
/obj/machinery/atmospherics/pipe/simple/supply/hidden,
/obj/machinery/suit_storage_unit/mining/eva,
/obj/effect/decal/cleanable/dirt/dust,
/obj/effect/decal/cleanable/dirt,
/turf/open/floor/plasteel,
/area/shuttle/abandoned/cargo)
"Er" = (
/obj/effect/turf_decal/caution/stand_clear,
/obj/effect/turf_decal/stripes/line{
	dir = 1
	},
/obj/machinery/button/door{
	id = "pubbywspodnw";
	name = "Pod Door Control";
	pixel_x = -24;
	pixel_y = 0
	},
/obj/machinery/light{
	dir = 8
	},
/obj/effect/decal/cleanable/dirt/dust,
/turf/open/floor/engine,
/area/shuttle/abandoned/cargo)
"Fa" = (
/obj/structure/window/reinforced{
	dir = 1;
	layer = 2.9
	},
/obj/effect/turf_decal/box,
/obj/structure/closet/crate,
/obj/item/pickaxe/drill,
/obj/item/pickaxe/drill,
/obj/item/gun/energy/kinetic_accelerator,
/obj/item/gun/energy/kinetic_accelerator,
/obj/effect/decal/cleanable/dirt/dust,
/obj/effect/decal/cleanable/dirt,
/turf/open/floor/plasteel,
/area/shuttle/abandoned/cargo)
"Fu" = (
/obj/machinery/atmospherics/pipe/manifold/supply/hidden{
	dir = 8
	},
/obj/effect/decal/cleanable/dirt/dust,
/mob/living/simple_animal/hostile/hivebot,
/obj/effect/decal/cleanable/dirt,
/turf/open/floor/plating,
/area/shuttle/abandoned/engine)
"FG" = (
/obj/structure/window/reinforced,
/obj/effect/turf_decal/box,
/obj/machinery/mineral/equipment_vendor,
/obj/effect/decal/cleanable/dirt/dust,
/obj/effect/decal/cleanable/dirt,
/turf/open/floor/plasteel,
/area/shuttle/abandoned/cargo)
"FH" = (
/obj/effect/turf_decal/box/corners{
	dir = 8
	},
/obj/effect/decal/cleanable/dirt/dust,
/turf/open/floor/engine,
/area/shuttle/abandoned/cargo)
"Gm" = (
/obj/machinery/door/airlock/external/glass,
/obj/effect/mapping_helpers/airlock/cyclelink_helper,
/obj/docking_port/mobile{
	callTime = 250;
	dir = 2;
	dwidth = 11;
	height = 12;
	id = "whiteship";
	launch_status = 0;
	movement_force = list("KNOCKDOWN" = 0, "THROW" = 0);
	name = "White Ship";
	port_direction = 8;
	preferred_direction = 4;
	width = 24
	},
/obj/machinery/door/firedoor/border_only,
/obj/machinery/door/firedoor/border_only{
	dir = 1
	},
/obj/effect/decal/cleanable/dirt/dust,
/obj/effect/decal/cleanable/dirt,
/turf/open/floor/plasteel/dark,
/area/shuttle/abandoned/cargo)
"Ha" = (
/obj/structure/window/reinforced,
/obj/effect/turf_decal/box,
/obj/structure/table/reinforced,
/obj/item/storage/belt/utility,
/obj/item/storage/belt/utility,
/obj/effect/decal/cleanable/dirt/dust,
/obj/effect/decal/cleanable/dirt,
/turf/open/floor/plasteel,
/area/shuttle/abandoned/cargo)
"Hh" = (
/obj/structure/window/reinforced,
/obj/effect/turf_decal/box,
/obj/structure/table/reinforced,
/obj/machinery/atmospherics/pipe/simple/supply/hidden,
/obj/item/storage/firstaid,
/obj/item/storage/firstaid,
/obj/effect/decal/cleanable/dirt/dust,
/obj/effect/decal/cleanable/dirt,
/turf/open/floor/plasteel,
/area/shuttle/abandoned/cargo)
"Hn" = (
/obj/structure/spacepoddoor{
	dir = 4
	},
/turf/open/floor/engine,
/area/shuttle/abandoned/cargo)
"HE" = (
/obj/effect/decal/cleanable/dirt/dust,
/obj/effect/decal/cleanable/dirt,
/obj/machinery/computer/station_alert{
	dir = 8
	},
/turf/open/floor/plasteel/dark,
/area/shuttle/abandoned/bridge)
"If" = (
/turf/closed/wall/mineral/titanium/nodiagonal,
/area/shuttle/abandoned/bridge)
"Ih" = (
/obj/machinery/button/door{
	id = "pubbywspodse";
	name = "Pod Door Control";
	pixel_x = 24;
	pixel_y = 0
	},
/obj/effect/decal/cleanable/dirt/dust,
/turf/open/floor/engine,
/area/shuttle/abandoned/cargo)
"Io" = (
/obj/effect/turf_decal/box/corners{
	dir = 8
	},
/obj/effect/decal/cleanable/dirt/dust,
/mob/living/simple_animal/hostile/hivebot,
/turf/open/floor/engine,
/area/shuttle/abandoned/cargo)
"Is" = (
/obj/structure/window/reinforced,
/obj/effect/turf_decal/box,
/obj/structure/table/reinforced,
/obj/item/tank/jetpack/carbondioxide,
/obj/item/tank/jetpack/carbondioxide,
/obj/effect/decal/cleanable/dirt/dust,
/obj/effect/decal/cleanable/dirt,
/turf/open/floor/plasteel,
/area/shuttle/abandoned/cargo)
"IE" = (
/obj/effect/decal/cleanable/dirt/dust,
/obj/effect/decal/cleanable/dirt,
/turf/open/floor/plasteel/dark,
/area/shuttle/abandoned/bridge)
"JN" = (
/obj/machinery/light{
	dir = 8
	},
/obj/structure/cable{
	icon_state = "1-2"
	},
/obj/effect/decal/cleanable/dirt/dust,
/obj/effect/decal/cleanable/dirt,
/turf/open/floor/plasteel/dark,
/area/shuttle/abandoned/bridge)
"JV" = (
/obj/structure/ore_box,
/obj/effect/decal/cleanable/dirt/dust,
/obj/effect/decal/cleanable/dirt,
/turf/open/floor/plating,
/area/shuttle/abandoned/engine)
"KB" = (
/obj/effect/decal/cleanable/dirt/dust,
/obj/structure/chair/comfy/shuttle{
	dir = 4
	},
/obj/effect/decal/cleanable/dirt,
/turf/open/floor/plasteel/dark,
/area/shuttle/abandoned/bridge)
"KO" = (
/obj/machinery/power/smes{
	charge = 1e+006
	},
/obj/structure/cable{
	icon_state = "0-4"
	},
/obj/effect/decal/cleanable/dirt/dust,
/obj/effect/decal/cleanable/dirt,
/turf/open/floor/plating,
/area/shuttle/abandoned/engine)
"KU" = (
/obj/effect/decal/cleanable/dirt/dust,
/obj/effect/decal/cleanable/dirt,
/mob/living/simple_animal/hostile/hivebot,
/turf/open/floor/plating,
/area/shuttle/abandoned/engine)
"Lu" = (
/obj/machinery/power/apc/auto_name/east{
	pixel_x = 24
	},
/obj/structure/cable,
/obj/structure/cable{
	icon_state = "0-2"
	},
/obj/effect/decal/cleanable/dirt/dust,
/obj/effect/decal/cleanable/dirt,
/turf/open/floor/plating,
/area/shuttle/abandoned/engine)
"Mi" = (
/turf/closed/wall/mineral/titanium/nodiagonal,
/area/shuttle/abandoned/engine)
"MY" = (
/obj/machinery/door/airlock/titanium/glass,
/obj/effect/decal/cleanable/dirt/dust,
/obj/effect/decal/cleanable/dirt,
/turf/open/floor/plasteel/dark,
/area/shuttle/abandoned/bridge)
"NK" = (
/obj/machinery/door/window/eastleft,
/obj/effect/decal/cleanable/dirt/dust,
/obj/effect/decal/cleanable/dirt,
/turf/open/floor/plasteel/dark,
/area/shuttle/abandoned/cargo)
"NT" = (
/obj/machinery/door/airlock/external/glass,
/obj/effect/mapping_helpers/airlock/cyclelink_helper,
/obj/machinery/door/firedoor/border_only{
	dir = 1
	},
/obj/machinery/door/firedoor/border_only,
/obj/effect/decal/cleanable/dirt/dust,
/obj/effect/decal/cleanable/dirt,
/turf/open/floor/plasteel/dark,
/area/shuttle/abandoned/cargo)
"Or" = (
/obj/effect/decal/cleanable/dirt/dust,
/obj/effect/decal/cleanable/dirt,
/obj/structure/chair/comfy/shuttle{
	dir = 4
	},
/turf/open/floor/plasteel/dark,
/area/shuttle/abandoned/bridge)
"Ov" = (
/obj/machinery/atmospherics/pipe/manifold/supply/hidden{
	dir = 1
	},
/obj/machinery/mineral/ore_redemption,
/obj/structure/cable{
	icon_state = "4-8"
	},
/obj/effect/decal/cleanable/dirt/dust,
/obj/effect/decal/cleanable/dirt,
/turf/open/floor/plasteel/dark,
/area/shuttle/abandoned/cargo)
"OI" = (
/obj/effect/decal/cleanable/dirt/dust,
/turf/open/floor/engine,
/area/shuttle/abandoned/cargo)
"Pg" = (
/obj/machinery/door/airlock/external,
/obj/effect/mapping_helpers/airlock/cyclelink_helper{
	dir = 8
	},
/obj/machinery/door/firedoor/border_only{
	dir = 4
	},
/obj/machinery/door/firedoor/border_only{
	dir = 8
	},
/obj/effect/decal/cleanable/dirt/dust,
/obj/effect/decal/cleanable/dirt,
/turf/open/floor/plating,
/area/shuttle/abandoned/engine)
"Pu" = (
/obj/effect/turf_decal/stripes/line{
	dir = 8
	},
/obj/machinery/atmospherics/components/unary/vent_pump/on{
	dir = 4
	},
/obj/effect/decal/cleanable/dirt/dust,
/obj/effect/decal/cleanable/dirt,
/turf/open/floor/plating,
/area/shuttle/abandoned/engine)
"QO" = (
/obj/effect/turf_decal/stripes/line{
	dir = 1
	},
/obj/effect/decal/cleanable/dirt/dust,
/turf/open/floor/engine,
/area/shuttle/abandoned/cargo)
"QU" = (
/obj/effect/turf_decal/box/corners{
	dir = 1
	},
/obj/effect/decal/cleanable/dirt/dust,
/mob/living/simple_animal/hostile/hivebot,
/turf/open/floor/engine,
/area/shuttle/abandoned/cargo)
"RC" = (
/obj/effect/turf_decal/stripes/line,
/obj/effect/decal/cleanable/dirt/dust,
/turf/open/floor/engine,
/area/shuttle/abandoned/cargo)
"RW" = (
/obj/structure/reagent_dispensers/fueltank,
/obj/effect/decal/cleanable/dirt/dust,
/obj/effect/decal/cleanable/dirt,
/turf/open/floor/plating,
/area/shuttle/abandoned/engine)
"RZ" = (
/obj/structure/window/reinforced{
	dir = 1;
	layer = 2.9
	},
/obj/effect/turf_decal/box,
/obj/structure/table/reinforced,
/obj/machinery/microwave,
/obj/machinery/light{
	dir = 8
	},
/obj/effect/decal/cleanable/dirt/dust,
/obj/effect/decal/cleanable/dirt,
/turf/open/floor/plasteel,
/area/shuttle/abandoned/cargo)
"Sg" = (
/obj/structure/window/reinforced{
	dir = 1;
	layer = 2.9
	},
/obj/effect/turf_decal/box,
/obj/structure/tank_dispenser,
/obj/effect/decal/cleanable/dirt/dust,
/obj/effect/decal/cleanable/dirt,
/turf/open/floor/plasteel,
/area/shuttle/abandoned/cargo)
"Si" = (
/obj/structure/window/reinforced,
/obj/effect/turf_decal/box,
/obj/machinery/airalarm/directional/east{
	pixel_x = 24
	},
/obj/structure/closet/crate,
/obj/item/spacepod_equipment/weaponry/plasma_cutter,
/obj/item/spacepod_equipment/cargo/large/ore,
/obj/item/pod_parts/armor/industrial,
/obj/item/circuitboard/mecha/pod,
/obj/item/pod_parts/core,
/obj/machinery/light{
	dir = 4
	},
/obj/effect/decal/cleanable/dirt/dust,
/obj/effect/decal/cleanable/dirt,
/turf/open/floor/plasteel,
/area/shuttle/abandoned/cargo)
"TU" = (
/obj/machinery/door/window/eastright,
/obj/effect/decal/cleanable/dirt/dust,
/obj/effect/decal/cleanable/dirt,
/turf/open/floor/plasteel/dark,
/area/shuttle/abandoned/cargo)
"TZ" = (
/obj/machinery/atmospherics/components/unary/portables_connector,
/obj/machinery/portable_atmospherics/canister/air,
/obj/effect/decal/cleanable/dirt/dust,
/obj/effect/decal/cleanable/dirt,
/turf/open/floor/plating,
/area/shuttle/abandoned/engine)
"Uf" = (
/obj/effect/turf_decal/caution/stand_clear,
/obj/effect/turf_decal/stripes/line,
/obj/effect/decal/cleanable/dirt/dust,
/turf/open/floor/engine,
/area/shuttle/abandoned/cargo)
"Uk" = (
/obj/structure/window/reinforced{
	dir = 1;
	layer = 2.9
	},
/obj/effect/turf_decal/box,
/obj/machinery/atmospherics/pipe/simple/supply/hidden,
/obj/machinery/suit_storage_unit/mining/eva,
/obj/effect/decal/cleanable/dirt/dust,
/obj/effect/decal/cleanable/dirt,
/turf/open/floor/plasteel,
/area/shuttle/abandoned/cargo)
"Uy" = (
/obj/machinery/door/airlock/external,
/obj/effect/mapping_helpers/airlock/cyclelink_helper{
	dir = 4
	},
/obj/machinery/door/firedoor/border_only{
	dir = 4
	},
/obj/machinery/door/firedoor/border_only{
	dir = 8
	},
/obj/effect/decal/cleanable/dirt/dust,
/obj/effect/decal/cleanable/dirt,
/turf/open/floor/plating,
/area/shuttle/abandoned/engine)
"UD" = (
/obj/effect/decal/cleanable/dirt/dust,
/obj/machinery/computer/camera_advanced/shuttle_docker/whiteship{
	dir = 8;
	view_range = 14;
	x_offset = -4;
	y_offset = -8
	},
/obj/effect/decal/cleanable/dirt,
/turf/open/floor/plasteel/dark,
/area/shuttle/abandoned/bridge)
"UP" = (
/obj/machinery/power/terminal{
	dir = 4
	},
/obj/machinery/power/port_gen/pacman{
	anchored = 1
	},
/obj/machinery/light{
	dir = 1
	},
/obj/effect/decal/cleanable/dirt/dust,
/obj/effect/decal/cleanable/dirt,
/turf/open/floor/plating,
/area/shuttle/abandoned/engine)
"US" = (
/obj/effect/spawner/structure/window/shuttle,
/obj/machinery/door/poddoor{
	id = "whiteship_windows"
	},
/turf/open/floor/plating,
/area/shuttle/abandoned/engine)
"Vv" = (
/obj/machinery/atmospherics/pipe/simple/supply/hidden{
	dir = 4
	},
/obj/structure/cable{
	icon_state = "2-4"
	},
/obj/effect/decal/cleanable/dirt/dust,
/obj/effect/decal/cleanable/dirt,
/turf/open/floor/plating,
/area/shuttle/abandoned/engine)
"VO" = (
/obj/machinery/light,
/obj/effect/decal/cleanable/dirt/dust,
/obj/effect/decal/cleanable/dirt,
/turf/open/floor/plating,
/area/shuttle/abandoned/engine)
"Wg" = (
/obj/machinery/atmospherics/pipe/simple/supply/hidden{
	dir = 4
	},
/obj/structure/cable{
	icon_state = "4-8"
	},
/obj/effect/decal/cleanable/dirt/dust,
/obj/effect/decal/cleanable/dirt,
/turf/open/floor/plasteel/dark,
/area/shuttle/abandoned/cargo)
"WW" = (
/obj/structure/shuttle/engine/heater{
	dir = 8
	},
/turf/closed/wall/mineral/titanium/nodiagonal,
/area/shuttle/abandoned/engine)
"Xl" = (
/turf/closed/wall/mineral/titanium,
/area/shuttle/abandoned/bridge)
"XO" = (
/obj/machinery/atmospherics/components/unary/tank/air,
/obj/effect/decal/cleanable/dirt/dust,
/obj/effect/decal/cleanable/dirt,
/turf/open/floor/plating,
/area/shuttle/abandoned/engine)
"ZA" = (
/obj/effect/turf_decal/box/corners{
	dir = 4
	},
/obj/effect/decal/cleanable/dirt/dust,
/turf/open/floor/engine,
/area/shuttle/abandoned/cargo)

(1,1,1) = {"
qx
bn
US
US
bn
qx
qx
bn
US
US
bn
qx
"}
(2,1,1) = {"
qx
Mi
RW
jK
Mi
Uy
Uy
Mi
JV
KU
Mi
qx
"}
(3,1,1) = {"
qx
Mi
Cd
jK
Mi
Pu
in
Mi
hT
jK
Mi
qx
"}
(4,1,1) = {"
qx
Mi
JV
VO
Mi
pY
ml
Mi
UP
jK
Mi
qx
"}
(5,1,1) = {"
qx
Mi
JV
jK
bn
pt
Pg
bn
KO
jK
Mi
qx
"}
(6,1,1) = {"
qx
Mi
TZ
Fu
nS
BR
nv
ao
fm
jK
Mi
qx
"}
(7,1,1) = {"
oH
Mi
XO
Al
cF
Vv
tp
Lu
gU
uf
Mi
oH
"}
(8,1,1) = {"
WW
Mi
US
US
bn
pA
oT
bn
US
US
Mi
WW
"}
(9,1,1) = {"
Ea
Er
OI
OI
RZ
Wg
dy
ol
OI
OI
on
eT
"}
(10,1,1) = {"
Hn
QO
QU
FH
yR
Wg
dy
Ha
eQ
Io
RC
Hn
"}
(11,1,1) = {"
Hn
QO
ZA
gB
od
Wg
dy
Is
ZA
gB
RC
Hn
"}
(12,1,1) = {"
Hn
ss
OI
bg
mL
sh
mr
Hh
jQ
OI
Uf
Hn
"}
(13,1,1) = {"
au
au
au
Do
dy
Wg
dy
dy
wy
au
au
au
"}
(14,1,1) = {"
Gm
dy
AO
dy
dy
Ov
aV
dy
dy
NT
dy
AO
"}
(15,1,1) = {"
au
au
au
NK
dy
Wg
dy
dy
TU
au
au
au
"}
(16,1,1) = {"
ih
ss
OI
bg
Uk
sh
Cs
Eq
jQ
OI
Uf
pU
"}
(17,1,1) = {"
Hn
QO
eQ
xG
Fa
Wg
dy
gH
eQ
FH
RC
Hn
"}
(18,1,1) = {"
Hn
QO
ZA
gB
Sg
Wg
dy
FG
ZA
xh
RC
Hn
"}
(19,1,1) = {"
Hn
ss
jH
kJ
BB
mt
dy
Si
kJ
Ih
Uf
Hn
"}
(20,1,1) = {"
zv
zv
zv
zv
zv
dN
MY
zv
zv
zv
zv
zv
"}
(21,1,1) = {"
Xl
If
If
Bh
JN
er
IE
re
vG
If
If
Xl
"}
(22,1,1) = {"
qx
Xl
If
nB
Or
tN
KB
Or
hZ
If
Xl
qx
"}
(23,1,1) = {"
qx
qx
jf
kA
pu
Ei
UD
HE
kA
eo
qx
qx
"}
(24,1,1) = {"
qx
qx
qx
jf
tv
tv
iS
iS
eo
qx
qx
qx
"}
